Unnamed: 0,UUID,Status,Version,Start,Last,src_ip,src_port,dst_ip,dst_port,Protocol,ABBytes,BABytes,ABPackets,BAPackets,Action,Total_Packets,Total_Bytes
0,5d095ce8-4545-4d64-a35c-515d0597b628,ENDED,4.2,2019-07-02 17:05:24,2019-07-02 17:05:25,10.132.196.39,1602,10.2.163.108,80,TCP,12000000,12000000,7937,7937,ACCEPTED,15874,24000000
1,b1694e21-8268-4564-aadf-b06f9bfccfa9,ENDED,4.2,2019-07-02 17:06:13,2019-07-02 17:06:14,54.210.206.49,2352,10.2.163.104,80,TCP,4720,4720,4,4,ACCEPTED,8,9440
2,ebb7eb4f-612b-4cb0-863c-e2df3863b497,ENDED,4.2,2019-07-02 17:15:07,2019-07-02 17:15:08,54.210.144.91,2352,10.2.163.106,80,TCP,7584,7584,6,6,ACCEPTED,12,15168
3,cc7823bd-7186-42f7-b802-cf2dbf595fc0,ENDED,4.2,2019-07-02 17:45:42,2019-07-02 17:45:43,52.90.83.149,2352,10.2.163.103,80,TCP,2688,2688,2,2,ACCEPTED,4,5376
4,cc719b32-009c-4114-9d2e-e09da4f4eca3,ENDED,4.2,2019-07-02 17:08:27,2019-07-02 17:08:28,10.110.215.196,1587,10.2.163.103,80,TCP,64000,64000,43,43,ACCEPTED,86,128000
5,60340c77-d561-4f16-9692-5ac1bca71ec3,ENDED,4.2,2019-07-02 17:08:38,2019-07-02 17:08:38,10.110.215.196,1587,10.2.163.107,80,TCP,64000,64000,43,43,ACCEPTED,86,128000
6,e8aaebd8-4070-4ad8-8014-8da365c22492,ENDED,4.2,2019-07-02 17:09:43,2019-07-02 17:09:44,10.132.196.39,1602,10.2.163.107,80,TCP,12000000,12000000,7937,7937,ACCEPTED,15874,24000000
7,8a9503d8-580a-429a-b57f-9e6dd696a268,ENDED,4.2,2019-07-02 17:11:20,2019-07-02 17:11:20,10.110.215.196,1587,10.2.163.103,80,TCP,64000,64000,43,43,ACCEPTED,86,128000
8,d9297d4a-9497-473a-89f0-9a8e2b13f92b,ENDED,4.2,2019-07-02 17:13:38,2019-07-02 17:13:39,54.210.144.91,2352,10.2.163.106,80,TCP,1632,1632,2,2,ACCEPTED,4,3264
9,927e82c5-c063-469a-850e-94c0fd705fbb,ENDED,4.2,2019-07-02 17:35:50,2019-07-02 17:35:50,10.110.215.196,1587,10.2.163.108,80,TCP,64000,64000,43,43,ACCEPTED,86,128000
10,d2b8dd7f-e75d-4f0d-b38f-4d48dcf484f4,ENDED,4.2,2019-07-02 17:36:23,2019-07-02 17:36:24,52.90.83.149,2352,10.2.163.103,80,TCP,1616,1616,2,2,ACCEPTED,4,3232
11,db7f80b8-8cf1-45ea-a22d-1f50b50b6d01,ENDED,4.2,2019-07-02 17:39:50,2019-07-02 17:39:50,10.110.215.196,1587,10.2.163.108,80,TCP,64000,64000,43,43,ACCEPTED,86,128000
12,ac011896-0322-4803-a82e-a3d2eeaea927,ENDED,4.2,2019-07-02 17:42:04,2019-07-02 17:42:04,52.90.83.149,2352,10.2.163.103,80,TCP,2560,2560,2,2,ACCEPTED,4,5120
13,b9507c7d-df72-4b89-b65c-d35a6af35d50,ENDED,4.2,2019-07-02 17:44:31,2019-07-02 17:44:31,10.110.215.196,1587,10.2.163.105,80,TCP,64000,64000,43,43,ACCEPTED,86,128000
14,e2192871-4cf3-4b7e-ae18-0d8f5fa3acc6,ENDED,4.2,2019-07-02 17:55:28,2019-07-02 17:55:28,10.110.215.196,1587,10.2.163.107,80,TCP,64000,64000,43,43,ACCEPTED,86,128000
15,f5d701ee-51d4-40d6-8172-2ee63493dacc,ENDED,4.2,2019-07-02 17:57:48,2019-07-02 17:57:48,10.110.215.196,1587,10.2.163.107,80,TCP,64000,64000,43,43,ACCEPTED,86,128000
16,453d66d0-9250-41c5-a7de-efb665f516c0,ENDED,4.2,2019-07-02 17:11:36,2019-07-02 17:11:36,52.90.83.149,2352,10.2.163.107,80,TCP,91904,91904,61,61,ACCEPTED,122,183808
17,a475c796-4d5f-4a01-8ee6-ebd59202c213,ENDED,4.2,2019-07-02 17:26:39,2019-07-02 17:26:39,10.110.111.176,2081,10.2.163.106,80,TCP,5915,5915,4,4,ACCEPTED,8,11830
18,3c46205b-3a52-4bf7-bba8-4bbc609f6e15,ENDED,4.2,2019-07-02 17:19:05,2019-07-02 17:19:05,10.110.215.196,1587,10.2.163.106,80,TCP,64000,64000,43,43,ACCEPTED,86,128000
19,e41b48ad-115b-4191-879c-27e9ed667543,ENDED,4.2,2019-07-02 17:25:29,2019-07-02 17:25:29,10.143.99.78,1253,10.2.163.104,80,TCP,489,489,1,1,ACCEPTED,2,978
20,c77844e5-7228-4405-9304-b241dce0a604,ENDED,4.2,2019-07-02 17:44:25,2019-07-02 17:44:25,10.110.111.165,2081,10.2.163.103,80,TCP,903087,903087,598,598,ACCEPTED,1196,1806174
21,79478cff-fba6-4371-88a2-5aeb205d7b37,ENDED,4.2,2019-07-02 17:20:06,2019-07-02 17:20:06,54.210.144.91,2352,10.2.163.103,80,TCP,1968,1968,2,2,ACCEPTED,4,3936
22,e808f2d6-0bb0-4f05-955c-48884912b70b,ENDED,4.2,2019-07-02 17:20:25,2019-07-02 17:20:26,10.110.215.196,1587,10.2.163.106,80,TCP,8096000,8096000,5355,5355,ACCEPTED,10710,16192000
23,9d7c7dca-0e29-4dd7-bd0a-9bd937ea54ff,ENDED,4.2,2019-07-02 17:21:58,2019-07-02 17:21:58,10.110.111.177,2081,10.2.163.105,80,TCP,159,159,1,1,ACCEPTED,2,318
24,917ad2d9-4b33-4c56-be15-fe257ba7f33e,ENDED,4.2,2019-07-02 17:40:19,2019-07-02 17:40:19,10.110.215.196,1587,10.2.163.108,80,TCP,64000,64000,43,43,ACCEPTED,86,128000
25,de58da20-0004-4892-be38-96fcf8274f0f,ENDED,4.2,2019-07-02 17:23:23,2019-07-02 17:23:23,54.152.216.199,2352,10.2.163.103,80,TCP,2016,2016,2,2,ACCEPTED,4,4032
26,c9da7c02-296f-41dc-8c47-34c1fdfedc58,ENDED,4.2,2019-07-02 17:26:50,2019-07-02 17:26:50,10.110.215.196,1587,10.2.163.106,80,TCP,64000,64000,43,43,ACCEPTED,86,128000
27,f8319c51-38fe-4f47-8221-15854090a300,ENDED,4.2,2019-07-02 17:00:05,2019-07-02 17:00:05,10.110.215.196,1587,10.2.163.105,80,TCP,64000,64000,43,43,ACCEPTED,86,128000
28,206fc468-dac9-4c08-b98c-6e3bd0154789,ENDED,4.2,2019-07-02 17:22:14,2019-07-02 17:22:14,54.152.216.199,2352,10.2.163.103,80,TCP,6736,6736,5,5,ACCEPTED,10,13472
29,e9268dc0-6447-4509-9db6-2957f1a68e34,ENDED,4.2,2019-07-02 17:30:23,2019-07-02 17:30:24,54.210.144.91,2352,10.2.163.107,80,TCP,1344,1344,1,1,ACCEPTED,2,2688
30,477ef5b9-70d5-4103-a7a5-718f221831ea,ENDED,4.2,2019-07-02 17:30:55,2019-07-02 17:30:55,10.110.215.196,1587,10.2.163.106,80,TCP,64000,64000,43,43,ACCEPTED,86,128000
31,3d291bb0-72cb-494a-948c-6289badcdafb,ENDED,4.2,2019-07-02 17:29:31,2019-07-02 17:29:31,10.110.215.196,1587,10.2.163.108,80,TCP,64000,64000,43,43,ACCEPTED,86,128000
32,64b4ce83-bed7-4bb9-99e4-b37b49ba6e86,ENDED,4.2,2019-07-02 17:40:27,2019-07-02 17:40:28,54.152.216.199,2352,10.2.163.103,80,TCP,16896,16896,12,12,ACCEPTED,24,33792
33,6e9d9a24-01c1-4524-93b6-42f0a9bd5352,ENDED,4.2,2019-07-02 17:38:55,2019-07-02 17:38:55,10.110.215.196,1587,10.2.163.108,80,TCP,64000,64000,43,43,ACCEPTED,86,128000
34,baf36d94-29b5-4268-a5a5-1b3e27ea7a57,ENDED,4.2,2019-07-02 17:26:31,2019-07-02 17:26:31,10.110.215.196,1587,10.2.163.106,80,TCP,64000,64000,43,43,ACCEPTED,86,128000
35,63a38201-eeee-4911-9300-374e57ca3940,ENDED,4.2,2019-07-02 17:27:39,2019-07-02 17:27:39,10.110.215.196,1587,10.2.163.108,80,TCP,64000,64000,43,43,ACCEPTED,86,128000
36,f4cd0077-042e-4e2f-956f-d5ea1037771f,ENDED,4.2,2019-07-02 17:28:03,2019-07-02 17:28:04,10.110.215.196,1587,10.2.163.108,80,TCP,8096000,8096000,5355,5355,ACCEPTED,10710,16192000
37,da281ac8-91bb-45f2-991f-57d7c1c16bc7,ENDED,4.2,2019-07-02 17:58:37,2019-07-02 17:58:38,52.90.83.149,2352,10.2.163.107,80,TCP,5872,5872,4,4,ACCEPTED,8,11744
38,3a8119e4-7372-47bd-a05d-f5fa55f5e7ad,ENDED,4.2,2019-07-02 17:57:12,2019-07-02 17:57:13,52.90.83.149,2352,10.2.163.107,80,TCP,10848,10848,8,8,ACCEPTED,16,21696
39,4b682f04-5364-476c-ac87-96e7ae69fe6f,ENDED,4.2,2019-07-02 17:15:09,2019-07-02 17:15:10,54.152.216.199,2352,10.2.163.105,80,TCP,373536,373536,248,248,ACCEPTED,496,747072
40,acda304c-cec9-4555-9a86-d9f783f05ff0,ENDED,4.2,2019-07-02 17:19:01,2019-07-02 17:19:02,10.110.215.196,1587,10.2.163.106,80,TCP,8096000,8096000,5355,5355,ACCEPTED,10710,16192000
41,99124597-5ffe-4045-bd20-94fa4e7e4b21,ENDED,4.2,2019-07-02 17:33:58,2019-07-02 17:33:59,10.110.111.165,2081,10.2.163.107,80,TCP,180,180,1,1,ACCEPTED,2,360
42,48c9764e-de51-4bc2-8ac2-68cfd113301f,ENDED,4.2,2019-07-02 17:45:22,2019-07-02 17:45:22,10.110.215.196,1587,10.2.163.108,80,TCP,64000,64000,43,43,ACCEPTED,86,128000
43,68550544-a702-4ca7-a073-547c72bacccb,ENDED,4.2,2019-07-02 17:48:45,2019-07-02 17:48:45,10.110.215.196,1587,10.2.163.108,80,TCP,64000,64000,43,43,ACCEPTED,86,128000
44,a5512577-c9af-445c-a00b-b0a61d892b34,ENDED,4.2,2019-07-02 17:08:29,2019-07-02 17:08:30,10.110.111.177,2081,10.2.163.108,80,TCP,5027209,5027209,3325,3325,ACCEPTED,6650,10054418
45,b94ab627-3b5a-4972-81c5-2c19a06a152a,ENDED,4.2,2019-07-02 17:11:46,2019-07-02 17:11:46,54.152.216.199,2352,10.2.163.105,80,TCP,6736,6736,5,5,ACCEPTED,10,13472
46,273b2dc6-363c-4843-a06e-4f3d7f8a3a19,ENDED,4.2,2019-07-02 17:12:01,2019-07-02 17:12:01,54.152.216.199,2352,10.2.163.105,80,TCP,46272,46272,31,31,ACCEPTED,62,92544
47,c333b6d5-31bc-44f1-aa2b-40c996478465,ENDED,4.2,2019-07-02 17:18:29,2019-07-02 17:18:29,10.110.215.196,1587,10.2.163.106,80,TCP,64000,64000,43,43,ACCEPTED,86,128000
48,d4d6a203-8bee-4398-bf6d-a7c72d321741,ENDED,4.2,2019-07-02 17:24:24,2019-07-02 17:24:24,54.152.216.199,2352,10.2.163.107,80,TCP,25888,25888,18,18,ACCEPTED,36,51776
49,91a17f92-5b33-42b1-82c9-3a2d7dbe1882,ENDED,4.2,2019-07-02 17:24:59,2019-07-02 17:24:59,54.152.216.199,2352,10.2.163.107,80,TCP,22144,22144,15,15,ACCEPTED,30,44288
50,53b52dbf-e196-4e23-8b9f-3d5952252e8b,ENDED,4.2,2019-07-02 17:44:37,2019-07-02 17:44:37,10.110.215.196,1587,10.2.163.108,80,TCP,64000,64000,43,43,ACCEPTED,86,128000
51,2b984425-a12a-4b2e-b2db-1b33436fa42f,ENDED,4.2,2019-07-02 17:12:24,2019-07-02 17:12:25,10.110.215.196,1587,10.2.163.107,80,TCP,64000,64000,43,43,ACCEPTED,86,128000
52,f4e593c5-ee80-4c24-a27c-4b3e7cb5dfb1,ENDED,4.2,2019-07-02 17:54:48,2019-07-02 17:54:48,10.110.215.196,1587,10.2.163.107,80,TCP,8096000,8096000,5355,5355,ACCEPTED,10710,16192000
53,4bd6e721-9309-44c2-92c1-dcfc5afebd5c,ENDED,4.2,2019-07-02 17:07:43,2019-07-02 17:07:44,54.210.206.49,2352,10.2.163.107,80,TCP,16160,16160,11,11,ACCEPTED,22,32320
54,0aa87070-03cb-402f-83ec-4d9ad6f5aba2,ENDED,4.2,2019-07-02 17:11:24,2019-07-02 17:11:24,10.110.215.196,1587,10.2.163.103,80,TCP,64000,64000,43,43,ACCEPTED,86,128000
55,219e2b86-41c6-4136-8e8f-2a032a7012b1,ENDED,4.2,2019-07-02 17:13:30,2019-07-02 17:13:32,54.210.206.49,2352,10.2.163.107,80,TCP,16480,16480,11,11,ACCEPTED,22,32960
56,47e1e970-d737-488c-98e8-53652b915296,ENDED,4.2,2019-07-02 17:16:44,2019-07-02 17:16:45,54.210.206.49,2352,10.2.163.107,80,TCP,15936,15936,11,11,ACCEPTED,22,31872
57,20757502-6dcb-4eaf-8bd9-a0e3aa07bdac,ENDED,4.2,2019-07-02 17:33:14,2019-07-02 17:33:15,54.173.221.36,2352,10.2.163.108,80,TCP,2496,2496,2,2,ACCEPTED,4,4992
58,85dc3caf-0087-43f2-93de-180242818926,ENDED,4.2,2019-07-02 17:37:41,2019-07-02 17:37:42,10.110.215.196,1587,10.2.163.108,80,TCP,64000,64000,43,43,ACCEPTED,86,128000
59,a2fd839d-2987-4727-95b8-482af912c4b0,ENDED,4.2,2019-07-02 17:42:42,2019-07-02 17:42:42,54.173.221.36,2352,10.2.163.108,80,TCP,4928,4928,4,4,ACCEPTED,8,9856
60,ce99d012-1b52-42b7-af95-192eb3e615a5,ENDED,4.2,2019-07-02 17:24:41,2019-07-02 17:24:43,161.202.24.115,1602,10.2.163.105,80,TCP,12000000,12000000,7937,7937,ACCEPTED,15874,24000000
61,7e82c892-aa3f-4381-8ce7-570c2bb89379,ENDED,4.2,2019-07-02 17:39:37,2019-07-02 17:39:37,10.110.215.196,1587,10.2.163.106,80,TCP,64000,64000,43,43,ACCEPTED,86,128000
62,0b411eff-73f5-4518-9707-16c73344935d,ENDED,4.2,2019-07-02 17:00:38,2019-07-02 17:00:39,54.173.221.36,2352,10.2.163.108,80,TCP,285728,285728,189,189,ACCEPTED,378,571456
63,aff0bd8f-063f-4a7e-9f2f-fe1ac543d9cf,ENDED,4.2,2019-07-02 17:38:17,2019-07-02 17:38:17,10.110.215.196,1587,10.2.163.106,80,TCP,64000,64000,43,43,ACCEPTED,86,128000
64,b757ffdf-2023-434f-9918-1a2bba993310,ENDED,4.2,2019-07-02 17:43:51,2019-07-02 17:43:51,54.210.144.91,2352,10.2.163.107,80,TCP,6112,6112,5,5,ACCEPTED,10,12224
65,4ec785d8-5279-4dee-99cb-d923d10126e5,ENDED,4.2,2019-07-02 17:53:41,2019-07-02 17:53:42,54.210.206.49,2352,10.2.163.105,80,TCP,7248,7248,5,5,ACCEPTED,10,14496
66,5f66965b-5217-4159-ada3-6aa66a0ed113,ENDED,4.2,2019-07-02 17:00:05,2019-07-02 17:00:05,10.110.215.196,1587,10.2.163.105,80,TCP,64000,64000,43,43,ACCEPTED,86,128000
67,a9686307-0ba9-4767-a392-6445c84eacda,ENDED,4.2,2019-07-02 17:02:01,2019-07-02 17:02:02,10.110.215.196,1587,10.2.163.105,80,TCP,8096000,8096000,5355,5355,ACCEPTED,10710,16192000
68,3cb4e9fb-6588-4975-adb8-38cad7a7d365,ENDED,4.2,2019-07-02 17:03:08,2019-07-02 17:03:09,10.110.215.196,1587,10.2.163.105,80,TCP,64000,64000,43,43,ACCEPTED,86,128000
69,ebe570ec-ba64-4f1b-9eef-753114652f0b,ENDED,4.2,2019-07-02 17:03:15,2019-07-02 17:03:15,10.110.215.196,1587,10.2.163.105,80,TCP,64000,64000,43,43,ACCEPTED,86,128000
70,6bfdc1b9-90c2-4126-b58f-344a188c43c9,ENDED,4.2,2019-07-02 17:07:43,2019-07-02 17:07:44,54.152.216.199,2352,10.2.163.104,80,TCP,1328,1328,1,1,ACCEPTED,2,2656
71,d5fa2873-46e3-4815-8a25-2b73bc427a36,ENDED,4.2,2019-07-02 17:08:09,2019-07-02 17:08:09,54.152.216.199,2352,10.2.163.104,80,TCP,1472,1472,1,1,ACCEPTED,2,2944
72,24bb11ff-f703-4a83-95a2-98d866a2b9eb,ENDED,4.2,2019-07-02 17:01:57,2019-07-02 17:01:57,10.110.215.196,1587,10.2.163.105,80,TCP,64000,64000,43,43,ACCEPTED,86,128000
73,b0ba1826-5d2c-4827-9cc7-3ae85b92947d,ENDED,4.2,2019-07-02 17:34:09,2019-07-02 17:34:10,54.152.216.199,2352,10.2.163.104,80,TCP,1328,1328,1,1,ACCEPTED,2,2656
74,1493954c-aaa6-4d57-b5b7-d676cc11331a,ENDED,4.2,2019-07-01 17:17:14,2019-07-01 17:17:15,10.110.215.0,1587,10.2.163.103,80,TCP,64000,64000,43,43,ACCEPTED,86,128000
75,20b00e19-f414-45ee-baf8-457143d1a7d5,ENDED,4.2,2019-07-01 17:19:00,2019-07-01 17:19:01,10.174.98.0,1602,10.2.163.104,80,TCP,12000000,12000000,7937,7937,ACCEPTED,15874,24000000
76,11d3c3e9-fa60-4797-b1cc-edc6a63a45c5,ENDED,4.2,2019-07-01 17:41:11,2019-07-01 17:41:13,10.174.98.0,1602,10.2.163.107,80,TCP,12000000,12000000,7937,7937,ACCEPTED,15874,24000000
77,d997e69b-613e-4e0b-8667-d76c164ab82e,ENDED,4.2,2019-07-01 17:48:37,2019-07-01 17:48:38,18.233.8.0,2352,10.2.163.107,80,TCP,47968,47968,32,32,ACCEPTED,64,95936
78,c2a2c927-3cb3-4bad-9064-b0a07bfda4fa,ENDED,4.2,2019-07-01 17:56:08,2019-07-01 17:56:08,18.233.8.0,2352,10.2.163.105,80,TCP,1376,1376,1,1,ACCEPTED,2,2752
79,6e6434b9-524b-4be9-93fd-6075ceb73834,ENDED,4.2,2019-07-01 17:56:25,2019-07-01 17:56:25,18.233.8.0,2352,10.2.163.105,80,TCP,5632,5632,4,4,ACCEPTED,8,11264
80,e4a37072-0df2-4c15-9689-f4de5dc6ef4e,ENDED,4.2,2019-07-01 17:22:22,2019-07-01 17:22:22,10.110.215.0,1587,10.2.163.108,80,TCP,64000,64000,43,43,ACCEPTED,86,128000
81,633886a9-41f2-4a0a-8fbd-263f9549e857,ENDED,4.2,2019-07-01 17:43:14,2019-07-01 17:43:15,3.88.28.0,2352,10.2.163.104,80,TCP,9328,9328,7,7,ACCEPTED,14,18656
82,bbaecd02-91ad-42f4-b85f-c7f48c2262a5,ENDED,4.2,2019-07-01 17:56:33,2019-07-01 17:56:34,18.233.8.0,2352,10.2.163.105,80,TCP,1280,1280,1,1,ACCEPTED,2,2560
83,4c89bc02-7b98-41b5-81d1-d9d40f9b0dbd,ENDED,4.2,2019-07-01 17:56:54,2019-07-01 17:56:54,18.233.8.0,2352,10.2.163.105,80,TCP,1280,1280,1,1,ACCEPTED,2,2560
84,8241e458-6991-47c5-be93-f61b40d0b0e5,ENDED,4.2,2019-07-01 17:17:04,2019-07-01 17:17:05,10.110.215.0,1587,10.2.163.103,80,TCP,64000,64000,43,43,ACCEPTED,86,128000
85,c2450dfa-1f67-4723-a262-752e61324664,ENDED,4.2,2019-07-01 17:22:17,2019-07-01 17:22:18,10.110.215.0,1587,10.2.163.107,80,TCP,64000,64000,43,43,ACCEPTED,86,128000
86,a98f4968-7581-4900-85c5-141155d9afda,ENDED,4.2,2019-07-01 17:24:15,2019-07-01 17:24:15,10.110.215.0,1587,10.2.163.107,80,TCP,64000,64000,43,43,ACCEPTED,86,128000
87,eff826c0-ee1d-47bc-bf64-d6ad9478d84f,ENDED,4.2,2019-07-01 17:25:20,2019-07-01 17:25:21,10.110.215.0,1587,10.2.163.107,80,TCP,64000,64000,43,43,ACCEPTED,86,128000
88,1245c42d-f529-4c6c-9c10-ab25b0a92079,ENDED,4.2,2019-07-01 17:34:47,2019-07-01 17:34:51,3.83.1.0,2352,10.2.163.108,80,TCP,16320,16320,11,11,ACCEPTED,22,32640
89,ebf87cb2-26b3-4198-9c93-23a7f4fb20d6,ENDED,4.2,2019-07-01 17:41:08,2019-07-01 17:41:13,3.83.1.0,2352,10.2.163.108,80,TCP,3968560,3968560,2625,2625,ACCEPTED,5250,7937120
90,34cc71f1-587f-4a00-a104-c4b44c7f96f8,ENDED,4.2,2019-07-01 17:25:59,2019-07-01 17:25:59,10.110.215.0,1587,10.2.163.107,80,TCP,64000,64000,43,43,ACCEPTED,86,128000
91,67d23612-e732-407d-8bbf-d98dc08e80ba,ENDED,4.2,2019-07-01 17:26:17,2019-07-01 17:26:18,10.110.111.0,2081,10.2.163.107,80,TCP,4411489,4411489,2918,2918,ACCEPTED,5836,8822978
92,7c067a87-3f95-477d-8942-82c2267b92ec,ENDED,4.2,2019-07-01 17:26:22,2019-07-01 17:26:22,10.110.215.0,1587,10.2.163.107,80,TCP,64000,64000,43,43,ACCEPTED,86,128000
93,95333301-e8a0-4e5f-8710-1576cc30b010,ENDED,4.2,2019-07-01 17:25:02,2019-07-01 17:25:02,10.110.215.0,1587,10.2.163.108,80,TCP,64000,64000,43,43,ACCEPTED,86,128000
94,c4be53b4-81f3-40bc-9e50-2c06b0c0b88f,ENDED,4.2,2019-07-01 17:28:02,2019-07-01 17:28:03,3.88.28.0,2352,10.2.163.108,80,TCP,6176,6176,5,5,ACCEPTED,10,12352
95,8ebc1cef-55c2-43f5-b363-06b85d908758,ENDED,4.2,2019-07-01 17:32:23,2019-07-01 17:32:23,3.88.28.0,2352,10.2.163.108,80,TCP,2016,2016,2,2,ACCEPTED,4,4032
96,fd9420b1-00a9-4127-a04e-2c71a71b78b2,ENDED,4.2,2019-07-01 17:26:02,2019-07-01 17:26:02,10.110.215.0,1587,10.2.163.108,80,TCP,64000,64000,43,43,ACCEPTED,86,128000
97,90d39b8f-f385-4f20-bf3d-ce0b4d782e35,ENDED,4.2,2019-07-01 17:24:31,2019-07-01 17:24:33,10.162.208.0,1602,10.2.163.106,80,TCP,12000000,12000000,7937,7937,ACCEPTED,15874,24000000
98,1ad9be1c-bf3f-4b60-92a3-c96a4814fd0e,ENDED,4.2,2019-07-01 17:25:10,2019-07-01 17:25:10,10.110.215.0,1587,10.2.163.107,80,TCP,64000,64000,43,43,ACCEPTED,86,128000
99,f5fe20b4-bc38-411e-931a-6185060f7185,ENDED,4.2,2019-07-01 17:32:06,2019-07-01 17:32:06,10.110.215.0,1587,10.2.163.105,80,TCP,64000,64000,43,43,ACCEPTED,86,128000
100,976a3ab7-ebff-443c-86a4-1340756195d1,ENDED,4.2,2019-07-01 17:01:15,2019-07-01 17:01:15,34.203.244.0,2352,10.2.163.106,80,TCP,2592,2592,2,2,ACCEPTED,4,5184
101,9a84ee91-14a2-4e68-bc7b-f5abaa5870c7,ENDED,4.2,2019-07-01 17:03:41,2019-07-01 17:03:42,3.88.28.0,2352,10.2.163.108,80,TCP,3584,3584,3,3,ACCEPTED,6,7168
102,cc906c3c-6e55-467f-a580-e797b10cd98b,ENDED,4.2,2019-07-01 17:23:50,2019-07-01 17:23:50,10.110.215.0,1587,10.2.163.107,80,TCP,64000,64000,43,43,ACCEPTED,86,128000
103,95b4327f-58a7-4802-b69d-0af53af9c82e,ENDED,4.2,2019-07-01 17:25:26,2019-07-01 17:25:26,10.110.215.0,1587,10.2.163.107,80,TCP,64000,64000,43,43,ACCEPTED,86,128000
104,0dfdd6c0-40b2-49d7-a28a-fa16354e41bf,ENDED,4.2,2019-07-01 17:26:40,2019-07-01 17:26:40,10.110.215.0,1587,10.2.163.107,80,TCP,64000,64000,43,43,ACCEPTED,86,128000
105,9628486c-ae03-44a1-a16d-ecf49d0f3118,ENDED,4.2,2019-07-01 17:31:40,2019-07-01 17:31:40,10.110.215.0,1587,10.2.163.106,80,TCP,64000,64000,43,43,ACCEPTED,86,128000
106,88493047-620f-422f-918f-1c195f5e5423,ENDED,4.2,2019-07-01 17:34:05,2019-07-01 17:34:05,10.110.215.0,1587,10.2.163.105,80,TCP,64000,64000,43,43,ACCEPTED,86,128000
107,20e942a3-38ed-4246-8d29-5b48c39eadb0,ENDED,4.2,2019-07-01 17:08:39,2019-07-01 17:08:39,10.110.215.0,1587,10.2.163.107,80,TCP,64000,64000,43,43,ACCEPTED,86,128000
108,86621087-5e28-430f-b923-b499ffef4ab0,ENDED,4.2,2019-07-01 17:35:33,2019-07-01 17:35:34,3.88.28.0,2352,10.2.163.103,80,TCP,30656,30656,21,21,ACCEPTED,42,61312
109,406e606e-c424-4161-a964-794da1d254be,ENDED,4.2,2019-07-01 17:54:29,2019-07-01 17:54:29,10.110.215.0,1587,10.2.163.106,80,TCP,64000,64000,43,43,ACCEPTED,86,128000
110,e8b06847-0b80-4570-8914-1271d1e99551,ENDED,4.2,2019-07-01 17:58:53,2019-07-01 17:58:53,10.110.215.0,1587,10.2.163.103,80,TCP,64000,64000,43,43,ACCEPTED,86,128000
111,df41f736-029f-4e78-84b2-6a367337f194,ENDED,4.2,2019-07-01 17:09:37,2019-07-01 17:09:38,10.110.215.0,1587,10.2.163.107,80,TCP,8096000,8096000,5355,5355,ACCEPTED,10710,16192000
112,77cd3815-65ff-4ac2-9b8c-95111361d23d,ENDED,4.2,2019-07-01 17:15:48,2019-07-01 17:15:48,10.110.215.0,1587,10.2.163.108,80,TCP,64000,64000,43,43,ACCEPTED,86,128000
113,360f5f49-e2b4-4da1-a584-83a8d0906941,ENDED,4.2,2019-07-01 17:18:31,2019-07-01 17:18:31,10.110.215.0,1587,10.2.163.108,80,TCP,64000,64000,43,43,ACCEPTED,86,128000
114,a6f4abfa-538e-4dc5-8a79-3106b2e9b39d,ENDED,4.2,2019-07-01 17:50:53,2019-07-01 17:50:53,10.110.215.0,1587,10.2.163.103,80,TCP,64000,64000,43,43,ACCEPTED,86,128000
115,1d08ea09-09a4-4324-bd3d-c47064981343,ENDED,4.2,2019-07-01 17:53:55,2019-07-01 17:53:55,10.110.215.0,1587,10.2.163.103,80,TCP,64000,64000,43,43,ACCEPTED,86,128000
116,9b739ada-cb2d-4d00-b5b5-c3afaab869c5,ENDED,4.2,2019-07-01 17:14:42,2019-07-01 17:14:42,10.110.215.0,1587,10.2.163.108,80,TCP,64000,64000,43,43,ACCEPTED,86,128000
117,abd48928-682c-4ff6-8d35-b002700ea38d,ENDED,4.2,2019-07-01 17:54:13,2019-07-01 17:54:14,10.110.215.0,1587,10.2.163.103,80,TCP,64000,64000,43,43,ACCEPTED,86,128000
118,43bca4d9-1b01-4a9c-bcbc-845d95651295,ENDED,4.2,2019-07-01 17:59:54,2019-07-01 17:59:55,18.233.8.0,2352,10.2.163.103,80,TCP,6144,6144,5,5,ACCEPTED,10,12288
119,449a1615-7b1e-4a0f-b41d-625c986a54e1,ENDED,4.2,2019-07-01 17:13:34,2019-07-01 17:13:34,10.110.215.0,1587,10.2.163.103,80,TCP,64000,64000,43,43,ACCEPTED,86,128000
120,3ea06b4a-de1e-4b53-8c9a-7c19ad1fe3a5,ENDED,4.2,2019-07-01 17:51:28,2019-07-01 17:51:28,10.110.215.0,1587,10.2.163.103,80,TCP,64000,64000,43,43,ACCEPTED,86,128000
121,f5e326d3-9124-4ab1-9605-c19ee4db49bb,ENDED,4.2,2019-07-01 17:04:29,2019-07-01 17:04:29,18.233.8.0,2352,10.2.163.103,80,TCP,3040,3040,3,3,ACCEPTED,6,6080
122,dd4b40f5-d2dd-4c77-bec1-5f1402ed32a9,ENDED,4.2,2019-07-01 17:06:06,2019-07-01 17:06:06,10.110.215.0,1587,10.2.163.105,80,TCP,64000,64000,43,43,ACCEPTED,86,128000
123,82515482-dcd4-4a22-a21b-872fa4801520,ENDED,4.2,2019-07-01 17:10:29,2019-07-01 17:10:29,10.110.111.0,2081,10.2.163.106,80,TCP,163,163,1,1,ACCEPTED,2,326
124,87916c81-4c93-4049-aa92-d9b39dc7d246,ENDED,4.2,2019-07-01 17:59:20,2019-07-01 17:59:20,10.110.215.0,1587,10.2.163.103,80,TCP,64000,64000,43,43,ACCEPTED,86,128000
125,2159fb4f-4f88-476e-8404-ac938a24e1d1,ENDED,4.2,2019-07-01 17:06:29,2019-07-01 17:06:30,10.110.215.0,1587,10.2.163.105,80,TCP,64000,64000,43,43,ACCEPTED,86,128000
126,635c4b43-4398-4987-baf1-82771475d913,ENDED,4.2,2019-07-01 17:17:56,2019-07-01 17:17:56,34.203.244.0,2352,10.2.163.107,80,TCP,7744,7744,6,6,ACCEPTED,12,15488
127,eefe63be-addc-4a3c-b230-8eaa0e5fadb5,ENDED,4.2,2019-07-01 17:21:37,2019-07-01 17:21:37,34.203.244.0,2352,10.2.163.107,80,TCP,1968,1968,2,2,ACCEPTED,4,3936
128,23b8d0cf-e493-4f42-a6bd-0484daebf1ea,ENDED,4.2,2019-07-01 17:59:02,2019-07-01 17:59:03,3.88.28.0,2352,10.2.163.107,80,TCP,67408,67408,45,45,ACCEPTED,90,134816
129,1713884f-1907-4ade-b1b5-68eeb0604e03,ENDED,4.2,2019-07-01 17:13:12,2019-07-01 17:13:12,3.94.82.0,2352,10.2.163.107,80,TCP,1824,1824,2,2,ACCEPTED,4,3648
130,0b2d19b5-b85e-4912-b279-5d94a049e13e,ENDED,4.2,2019-07-01 17:15:39,2019-07-01 17:15:40,3.83.1.0,2352,10.2.163.106,80,TCP,6336,6336,5,5,ACCEPTED,10,12672
131,ac072b2f-5bd5-4ed8-8f9c-a8739cf53431,ENDED,4.2,2019-07-01 17:19:32,2019-07-01 17:19:33,18.233.8.0,2352,10.2.163.103,80,TCP,6896,6896,5,5,ACCEPTED,10,13792
132,7bd38701-4f10-48b9-953c-5fefd28967a4,ENDED,4.2,2019-07-01 17:42:23,2019-07-01 17:42:23,10.110.215.0,1587,10.2.163.104,80,TCP,64000,64000,43,43,ACCEPTED,86,128000
133,fc957cd2-82fd-48f3-9463-43188d57158d,ENDED,4.2,2019-07-01 17:37:53,2019-07-01 17:37:54,18.233.8.0,2352,10.2.163.103,80,TCP,393792,393792,261,261,ACCEPTED,522,787584
134,dca6232e-8377-42f2-af6e-2d115e7c3546,ENDED,4.2,2019-07-01 17:39:39,2019-07-01 17:39:39,3.83.1.0,2352,10.2.163.106,80,TCP,6432,6432,5,5,ACCEPTED,10,12864
135,1a05cb4a-c712-49fe-aba8-e8a6f06ccdd5,ENDED,4.2,2019-07-01 17:43:49,2019-07-01 17:43:49,10.110.215.0,1587,10.2.163.104,80,TCP,64000,64000,43,43,ACCEPTED,86,128000
136,e7a9e96d-38fc-470a-90d8-562015c71f3b,ENDED,4.2,2019-07-01 17:42:39,2019-07-01 17:42:39,10.110.215.0,1587,10.2.163.104,80,TCP,64000,64000,43,43,ACCEPTED,86,128000
137,cd509e5f-3354-44de-8de9-45264a801f85,ENDED,4.2,2019-07-01 10:02:53,2019-07-01 10:02:53,10.110.215.0,1587,10.2.163.104,80,TCP,64000,64000,43,43,ACCEPTED,86,128000
138,c15dc65b-f86e-46f8-ba19-b3d53de0fba2,ENDED,4.2,2019-07-01 10:25:53,2019-07-01 10:25:53,52.87.236.0,2352,10.2.163.106,80,TCP,1904,1904,2,2,ACCEPTED,4,3808
139,94839e37-ca33-4659-81ba-b0c3a35e6a56,ENDED,4.2,2019-07-01 10:27:41,2019-07-01 10:27:41,10.110.215.0,1587,10.2.163.103,80,TCP,64000,64000,43,43,ACCEPTED,86,128000
140,a5a55c55-c287-48ca-bc02-72a982f5d893,ENDED,4.2,2019-07-01 10:29:56,2019-07-01 10:29:56,10.110.215.0,1587,10.2.163.103,80,TCP,64000,64000,43,43,ACCEPTED,86,128000
141,bd1d4202-3d1c-4a5a-878b-709e694eaf89,ENDED,4.2,2019-07-01 10:45:09,2019-07-01 10:45:09,10.110.215.0,1587,10.2.163.108,80,TCP,64000,64000,43,43,ACCEPTED,86,128000
142,1215af31-e94f-4820-ad99-e648947fb663,ENDED,4.2,2019-07-01 10:58:23,2019-07-01 10:58:23,10.110.215.0,1587,10.2.163.106,80,TCP,64000,64000,43,43,ACCEPTED,86,128000
143,f0313919-a78b-4a71-82a7-34dcd8bb0ce3,ENDED,4.2,2019-07-01 10:04:16,2019-07-01 10:04:16,10.110.215.0,1587,10.2.163.104,80,TCP,64000,64000,43,43,ACCEPTED,86,128000
144,67015474-597c-4bf3-b164-33449a918353,ENDED,4.2,2019-07-01 10:19:15,2019-07-01 10:19:15,13.114.248.0,1253,10.2.163.105,80,TCP,489,489,1,1,ACCEPTED,2,978
145,d82a5225-2339-43af-bbae-beb2357ba63f,ENDED,4.2,2019-07-01 10:22:04,2019-07-01 10:22:05,10.110.215.0,1587,10.2.163.104,80,TCP,64000,64000,43,43,ACCEPTED,86,128000
146,1b4e2669-b073-4471-abc0-2ab1aa04f42b,ENDED,4.2,2019-07-01 10:42:32,2019-07-01 10:42:33,3.94.101.0,2352,10.2.163.104,80,TCP,2400,2400,2,2,ACCEPTED,4,4800
147,a09fdde9-04d6-4ab9-bbf0-db39ffa241f7,ENDED,4.2,2019-07-01 10:10:33,2019-07-01 10:10:33,10.110.215.0,1587,10.2.163.107,80,TCP,64000,64000,43,43,ACCEPTED,86,128000
148,153448cf-e8ad-47f5-be3f-8c07dccdbc1d,ENDED,4.2,2019-07-01 10:13:13,2019-07-01 10:13:13,10.110.215.0,1587,10.2.163.107,80,TCP,64000,64000,43,43,ACCEPTED,86,128000
149,f0298a0e-8831-4d35-be79-ee14bc4af264,ENDED,4.2,2019-07-01 10:17:08,2019-07-01 10:17:09,52.87.236.0,2352,10.2.163.108,80,TCP,2704,2704,2,2,ACCEPTED,4,5408
150,ce1ce3fe-4ea2-4c7f-9663-25df0dc46f7d,ENDED,4.2,2019-07-01 10:21:48,2019-07-01 10:21:49,52.23.209.0,2352,10.2.163.108,80,TCP,6000,6000,4,4,ACCEPTED,8,12000
151,523e83cc-c79e-4807-a7dc-9a52fa8d484b,ENDED,4.2,2019-07-01 10:30:47,2019-07-01 10:30:47,10.110.215.0,1587,10.2.163.108,80,TCP,64000,64000,43,43,ACCEPTED,86,128000
152,bb07bf55-e61e-45f1-9586-abe33e98366a,ENDED,4.2,2019-07-01 10:54:18,2019-07-01 10:54:18,10.110.215.0,1587,10.2.163.106,80,TCP,64000,64000,43,43,ACCEPTED,86,128000
153,68d58e01-487f-4c64-b59a-0409794f6fdd,ENDED,4.2,2019-07-01 10:58:24,2019-07-01 10:58:24,10.110.215.0,1587,10.2.163.106,80,TCP,64000,64000,43,43,ACCEPTED,86,128000
154,12270df4-7993-4471-9040-ade30d9d29c5,ENDED,4.2,2019-07-01 10:09:59,2019-07-01 10:09:59,10.110.215.0,1587,10.2.163.107,80,TCP,64000,64000,43,43,ACCEPTED,86,128000
155,ed9eecf5-2664-40b9-9728-0795abbd63b0,ENDED,4.2,2019-07-01 10:28:50,2019-07-01 10:28:50,10.110.215.0,1587,10.2.163.108,80,TCP,64000,64000,43,43,ACCEPTED,86,128000
156,33c31546-a594-48e1-aad8-da2a74bbf903,ENDED,4.2,2019-07-01 10:02:37,2019-07-01 10:02:37,10.110.215.0,1587,10.2.163.105,80,TCP,64000,64000,43,43,ACCEPTED,86,128000
157,b460e03e-32ec-4e03-8695-8a42f9bf206a,ENDED,4.2,2019-07-01 10:02:37,2019-07-01 10:02:38,10.110.215.0,1587,10.2.163.105,80,TCP,64000,64000,43,43,ACCEPTED,86,128000
158,40155905-aaf2-47dc-817d-3faf4a134f76,ENDED,4.2,2019-07-01 10:00:23,2019-07-01 10:00:23,10.110.215.0,1587,10.2.163.105,80,TCP,64000,64000,43,43,ACCEPTED,86,128000
159,53831748-fa15-435e-98c3-e49dc1311714,ENDED,4.2,2019-07-01 10:28:41,2019-07-01 10:28:41,10.110.215.0,1587,10.2.163.103,80,TCP,64000,64000,43,43,ACCEPTED,86,128000
160,bb8844c3-bfa7-4afa-b02f-a2d43c1c0866,ENDED,4.2,2019-07-01 10:29:03,2019-07-01 10:29:04,10.110.215.0,1587,10.2.163.103,80,TCP,64000,64000,43,43,ACCEPTED,86,128000
161,25ee75e4-81a3-4a2c-b27f-923149488e90,ENDED,4.2,2019-07-01 10:29:23,2019-07-01 10:29:23,10.110.215.0,1587,10.2.163.108,80,TCP,64000,64000,43,43,ACCEPTED,86,128000
162,668a8f66-e2ec-480a-a977-9ac783de7ac2,ENDED,4.2,2019-07-01 10:49:27,2019-07-01 10:49:28,54.89.228.0,2352,10.2.163.107,80,TCP,142736,142736,95,95,ACCEPTED,190,285472
163,6c995481-a268-40b3-b8c3-9c6e641b3803,ENDED,4.2,2019-07-01 10:01:33,2019-07-01 10:01:33,10.110.215.0,1587,10.2.163.105,80,TCP,64000,64000,43,43,ACCEPTED,86,128000
164,a6d6e497-5618-4c9b-8ff7-98e37ff4ca9a,ENDED,4.2,2019-07-01 10:12:27,2019-07-01 10:12:28,52.23.209.0,2352,10.2.163.103,80,TCP,24384,24384,17,17,ACCEPTED,34,48768
165,41dcaad0-daf2-4e87-9379-f66015724c69,ENDED,4.2,2019-07-01 10:26:42,2019-07-01 10:26:42,10.110.215.0,1587,10.2.163.108,80,TCP,64000,64000,43,43,ACCEPTED,86,128000
166,f2f8af4f-b5e7-435e-bd13-0b62b1c7eb77,ENDED,4.2,2019-07-01 10:56:13,2019-07-01 10:56:13,10.110.215.0,1587,10.2.163.106,80,TCP,64000,64000,43,43,ACCEPTED,86,128000
167,f3dc6cbd-60c0-4d37-bca6-0268f310da66,ENDED,4.2,2019-07-01 10:56:46,2019-07-01 10:56:46,10.110.215.0,1587,10.2.163.106,80,TCP,64000,64000,43,43,ACCEPTED,86,128000
168,5e82fee1-2f4a-4461-88de-56cf56b74bb8,ENDED,4.2,2019-07-01 10:26:30,2019-07-01 10:26:30,10.110.215.0,1587,10.2.163.103,80,TCP,64000,64000,43,43,ACCEPTED,86,128000
169,a14da984-823d-41ff-8735-069c01e8066e,ENDED,4.2,2019-07-01 10:28:06,2019-07-01 10:28:06,10.110.215.0,1587,10.2.163.103,80,TCP,64000,64000,43,43,ACCEPTED,86,128000
170,7650692a-9a69-4a71-9d0c-ca60d3bbf2f2,ENDED,4.2,2019-07-01 10:35:30,2019-07-01 10:35:30,52.23.209.0,2352,10.2.163.106,80,TCP,4736,4736,4,4,ACCEPTED,8,9472
171,1f8ca502-0a7f-4e25-9fb1-9ff4a6867a65,ENDED,4.2,2019-07-01 10:35:42,2019-07-01 10:35:42,52.23.209.0,2352,10.2.163.106,80,TCP,6176,6176,5,5,ACCEPTED,10,12352
172,811acc14-6913-4299-abb4-2f5102ab83ee,ENDED,4.2,2019-07-01 10:44:56,2019-07-01 10:44:56,10.110.215.0,1587,10.2.163.108,80,TCP,64000,64000,43,43,ACCEPTED,86,128000
173,2a5042a3-e5dc-4ffb-b711-fad42a62b213,ENDED,4.2,2019-07-01 10:46:10,2019-07-01 10:46:10,10.110.215.0,1587,10.2.163.108,80,TCP,64000,64000,43,43,ACCEPTED,86,128000
174,9fd62163-f58f-4b4b-8fa0-ae2019e4af20,ENDED,4.2,2019-07-01 10:47:45,2019-07-01 10:47:45,10.110.215.0,1587,10.2.163.108,80,TCP,64000,64000,43,43,ACCEPTED,86,128000
175,9ff674bb-6096-49ee-a0eb-a1da4e0a411e,ENDED,4.2,2019-07-01 10:48:29,2019-07-01 10:48:30,10.110.215.0,1587,10.2.163.108,80,TCP,8096000,8096000,5355,5355,ACCEPTED,10710,16192000
176,dd3993a6-f131-4b84-b0bd-39ea80c6de63,ENDED,4.2,2019-07-01 10:48:36,2019-07-01 10:48:37,52.87.236.0,2352,10.2.163.107,80,TCP,1376,1376,1,1,ACCEPTED,2,2752
177,dcf19b96-81ab-46eb-8331-14aa4c65c4ec,ENDED,4.2,2019-07-01 10:05:52,2019-07-01 10:05:53,10.132.196.0,1602,10.2.163.108,80,TCP,12000000,12000000,7937,7937,ACCEPTED,15874,24000000
178,48f2b7b6-dcc5-4673-9682-f0a280257dca,ENDED,4.2,2019-07-01 10:17:59,2019-07-01 10:18:00,10.110.215.0,1587,10.2.163.107,80,TCP,64000,64000,43,43,ACCEPTED,86,128000
179,ccc1a79b-0088-4cc5-833d-5fc4792b8bde,ENDED,4.2,2019-07-01 10:25:06,2019-07-01 10:25:07,54.89.228.0,2352,10.2.163.108,80,TCP,64128,64128,43,43,ACCEPTED,86,128256
180,39186b41-8c51-47f8-8cc9-8dd893364f17,ENDED,4.2,2019-07-01 10:41:04,2019-07-01 10:41:05,52.87.236.0,2352,10.2.163.107,80,TCP,4821616,4821616,3189,3189,ACCEPTED,6378,9643232
181,791b1708-a2a3-45ac-9f96-2313cd851e7f,ENDED,4.2,2019-07-01 10:19:06,2019-07-01 10:19:06,10.110.215.0,1587,10.2.163.107,80,TCP,64000,64000,43,43,ACCEPTED,86,128000
182,509d1034-2190-4cf8-ab32-4bf81b8bfbe0,ENDED,4.2,2019-07-01 10:24:26,2019-07-01 10:24:26,52.87.236.0,2352,10.2.163.106,80,TCP,1552,1552,2,2,ACCEPTED,4,3104
183,1e86f85e-3e7e-4c93-a393-a1c2364c3885,ENDED,4.2,2019-07-01 10:27:32,2019-07-01 10:27:33,10.110.215.0,1587,10.2.163.108,80,TCP,64000,64000,43,43,ACCEPTED,86,128000
184,aafce078-d481-4445-9048-84861e986654,ENDED,4.2,2019-07-01 10:29:00,2019-07-01 10:29:01,10.110.215.0,1587,10.2.163.108,80,TCP,8096000,8096000,5355,5355,ACCEPTED,10710,16192000
185,b093e490-e819-414c-ae24-134c0ae39674,ENDED,4.2,2019-07-01 10:36:19,2019-07-01 10:36:20,10.110.215.0,1587,10.2.163.108,80,TCP,64000,64000,43,43,ACCEPTED,86,128000
186,f4188961-4735-4ea1-af05-e22cb1e10d1b,ENDED,4.2,2019-07-01 10:21:13,2019-07-01 10:21:14,10.110.215.0,1587,10.2.163.107,80,TCP,64000,64000,43,43,ACCEPTED,86,128000
187,8b6e4d40-acc5-43f5-b5da-01127d7dee77,ENDED,4.2,2019-07-01 10:26:04,2019-07-01 10:26:04,10.133.44.0,1472,10.2.163.106,80,TCP,25,25,1,1,ACCEPTED,2,50
188,7c891685-66d2-4fd7-8add-29606f7b9e5a,ENDED,4.2,2019-07-01 10:37:07,2019-07-01 10:37:07,10.110.215.0,1587,10.2.163.108,80,TCP,64000,64000,43,43,ACCEPTED,86,128000
189,0a1855c8-0bff-4574-bdf4-6bb9a2f38186,ENDED,4.2,2019-07-01 10:39:04,2019-07-01 10:39:04,10.110.215.0,1587,10.2.163.108,80,TCP,64000,64000,43,43,ACCEPTED,86,128000
190,b9d265fd-cc4c-462c-9ad7-818d276d461a,ENDED,4.2,2019-07-01 10:22:28,2019-07-01 10:22:29,10.110.215.0,1587,10.2.163.107,80,TCP,64000,64000,43,43,ACCEPTED,86,128000
191,a9f10b75-8230-44a2-a803-6e1d0d2d080a,ENDED,4.2,2019-07-01 10:36:08,2019-07-01 10:36:09,10.110.215.0,1587,10.2.163.108,80,TCP,8096000,8096000,5355,5355,ACCEPTED,10710,16192000
192,7fd945a7-0f28-4e04-ad9a-a2b87e9db305,ENDED,4.2,2019-07-01 10:12:27,2019-07-01 10:12:27,10.110.215.0,1587,10.2.163.106,80,TCP,64000,64000,43,43,ACCEPTED,86,128000
193,9266fa44-5185-48fb-9925-c8c67415703c,ENDED,4.2,2019-07-01 10:17:45,2019-07-01 10:17:45,10.110.215.0,1587,10.2.163.104,80,TCP,64000,64000,43,43,ACCEPTED,86,128000
194,b0b03d00-6039-455f-960b-523a641360ca,ENDED,4.2,2019-07-01 10:09:19,2019-07-01 10:09:19,10.110.215.0,1587,10.2.163.106,80,TCP,64000,64000,43,43,ACCEPTED,86,128000
195,e06d6b6b-467f-40bf-a732-44f83e7e053a,ENDED,4.2,2019-07-01 10:38:38,2019-07-01 10:38:38,10.110.215.0,1587,10.2.163.108,80,TCP,64000,64000,43,43,ACCEPTED,86,128000
196,a084d289-c5a1-4ba2-98ab-e6a735922d39,ENDED,4.2,2019-07-01 10:09:01,2019-07-01 10:09:02,10.110.215.0,1587,10.2.163.106,80,TCP,64000,64000,43,43,ACCEPTED,86,128000
197,077470b6-3241-49e7-93bb-510c7ffdfed0,ENDED,4.2,2019-07-01 10:00:08,2019-07-01 10:00:08,10.110.215.0,1587,10.2.163.104,80,TCP,64000,64000,43,43,ACCEPTED,86,128000
198,67e2d22f-cca1-44d6-bbe1-5fc3006f9234,ENDED,4.2,2019-07-01 10:02:31,2019-07-01 10:02:31,10.110.215.0,1587,10.2.163.104,80,TCP,64000,64000,43,43,ACCEPTED,86,128000
199,00dc9e17-3bde-4211-8afa-c3987d6b990d,ENDED,4.2,2019-07-01 10:04:20,2019-07-01 10:04:20,10.110.215.0,1587,10.2.163.104,80,TCP,64000,64000,43,43,ACCEPTED,86,128000
200,e4b9b02d-e788-4507-8120-ceb1e5353cc3,ENDED,4.2,2019-07-02 12:40:24,2019-07-02 12:40:25,54.152.216.199,2352,10.2.163.108,80,TCP,8240,8240,6,6,ACCEPTED,12,16480
201,c53b7da0-db35-4785-ae75-7761571a44ea,ENDED,4.2,2019-07-02 12:55:01,2019-07-02 12:55:02,54.210.206.49,2352,10.2.163.103,80,TCP,15104,15104,10,10,ACCEPTED,20,30208
202,cf116e09-8927-466e-8327-08bdd48f5348,ENDED,4.2,2019-07-02 12:57:10,2019-07-02 12:57:12,54.210.206.49,2352,10.2.163.107,80,TCP,10624,10624,8,8,ACCEPTED,16,21248
203,a295c053-cebd-404c-b814-5491264acb46,ENDED,4.2,2019-07-02 12:58:43,2019-07-02 12:58:44,54.210.206.49,2352,10.2.163.103,80,TCP,2576,2576,2,2,ACCEPTED,4,5152
204,c7c343ad-d5e1-4eea-b5f9-be305e1378c0,ENDED,4.2,2019-07-02 12:09:01,2019-07-02 12:09:01,10.110.215.196,1587,10.2.163.107,80,TCP,64000,64000,43,43,ACCEPTED,86,128000
205,d3e851fe-2180-4c66-9ba5-34491cd0a0ca,ENDED,4.2,2019-07-02 12:09:31,2019-07-02 12:09:31,10.110.215.196,1587,10.2.163.107,80,TCP,64000,64000,43,43,ACCEPTED,86,128000
206,e0506565-c183-493a-8873-1bd8d1894b71,ENDED,4.2,2019-07-02 12:55:20,2019-07-02 12:55:20,10.110.215.196,1587,10.2.163.106,80,TCP,64000,64000,43,43,ACCEPTED,86,128000
207,4754b8f3-9569-4010-a378-42dc2d173411,ENDED,4.2,2019-07-02 12:55:24,2019-07-02 12:55:24,10.110.215.196,1587,10.2.163.106,80,TCP,8096000,8096000,5355,5355,ACCEPTED,10710,16192000
208,06911278-bb0d-4702-9fab-f701b2790cef,ENDED,4.2,2019-07-02 12:02:26,2019-07-02 12:02:27,10.110.215.196,1587,10.2.163.108,80,TCP,8096000,8096000,5355,5355,ACCEPTED,10710,16192000
209,60bf08cc-4fc7-4fe6-8688-5db185e42029,ENDED,4.2,2019-07-02 12:16:52,2019-07-02 12:16:53,10.110.215.196,1587,10.2.163.103,80,TCP,64000,64000,43,43,ACCEPTED,86,128000
210,008c02ed-ad7b-45ff-90c5-fc928b44dc71,ENDED,4.2,2019-07-02 12:43:37,2019-07-02 12:43:37,10.110.215.196,1587,10.2.163.107,80,TCP,64000,64000,43,43,ACCEPTED,86,128000
211,a7761a56-5f57-4942-ba49-02dc9c7052e0,ENDED,4.2,2019-07-02 12:46:25,2019-07-02 12:46:26,10.110.215.196,1587,10.2.163.107,80,TCP,8096000,8096000,5355,5355,ACCEPTED,10710,16192000
212,49af6fab-4b84-47d3-abb9-5827350e79ac,ENDED,4.2,2019-07-02 12:07:10,2019-07-02 12:07:10,10.110.215.196,1587,10.2.163.104,80,TCP,64000,64000,43,43,ACCEPTED,86,128000
213,75073150-7abb-444b-9479-98a6688c11b7,ENDED,4.2,2019-07-02 12:17:56,2019-07-02 12:17:56,10.110.215.196,1587,10.2.163.103,80,TCP,64000,64000,43,43,ACCEPTED,86,128000
214,52eee244-1a17-4d61-99c2-cc439d09e0e3,ENDED,4.2,2019-07-02 12:20:00,2019-07-02 12:20:00,10.110.215.196,1587,10.2.163.103,80,TCP,64000,64000,43,43,ACCEPTED,86,128000
215,2a053851-5338-4ccf-bfc8-5d01cda7b978,ENDED,4.2,2019-07-02 12:44:36,2019-07-02 12:44:37,10.110.215.196,1587,10.2.163.107,80,TCP,64000,64000,43,43,ACCEPTED,86,128000
216,62326b63-b9e8-480c-ab21-5b9e52c92569,ENDED,4.2,2019-07-02 12:27:04,2019-07-02 12:27:04,18.195.163.71,1253,10.2.163.107,80,TCP,489,489,1,1,ACCEPTED,2,978
217,2bb2991b-09d3-42b5-b8e3-ea49119a5f50,ENDED,4.2,2019-07-02 12:26:02,2019-07-02 12:26:03,10.110.215.196,1587,10.2.163.106,80,TCP,64000,64000,43,43,ACCEPTED,86,128000
218,418c5b7a-f11d-46e9-9be7-b454afc05026,ENDED,4.2,2019-07-02 12:18:15,2019-07-02 12:18:15,10.110.215.196,1587,10.2.163.105,80,TCP,64000,64000,43,43,ACCEPTED,86,128000
219,847bcfba-ab50-46bc-91ec-33fa812b8719,ENDED,4.2,2019-07-02 12:19:22,2019-07-02 12:19:22,10.110.215.196,1587,10.2.163.105,80,TCP,64000,64000,43,43,ACCEPTED,86,128000
220,2a394c24-db3e-4619-b6c8-7a8420819167,ENDED,4.2,2019-07-02 12:20:21,2019-07-02 12:20:21,10.110.215.196,1587,10.2.163.105,80,TCP,64000,64000,43,43,ACCEPTED,86,128000
221,9fb9c004-a0e6-424f-b883-c003023ec827,ENDED,4.2,2019-07-02 12:38:38,2019-07-02 12:38:38,10.110.215.196,1587,10.2.163.107,80,TCP,64000,64000,43,43,ACCEPTED,86,128000
222,ad491761-47a6-4f50-bb32-8c0dc20eb4c8,ENDED,4.2,2019-07-02 12:54:44,2019-07-02 12:54:46,54.210.206.49,2352,10.2.163.106,80,TCP,1504,1504,1,1,ACCEPTED,2,3008
223,d773cc70-bf63-4378-a602-1efcd68b3ef4,ENDED,4.2,2019-07-02 12:20:26,2019-07-02 12:20:26,10.110.215.196,1587,10.2.163.105,80,TCP,64000,64000,43,43,ACCEPTED,86,128000
224,0b7c0005-5374-456a-bbe3-da12747578c4,ENDED,4.2,2019-07-02 12:35:27,2019-07-02 12:35:28,10.110.215.196,1587,10.2.163.107,80,TCP,64000,64000,43,43,ACCEPTED,86,128000
225,a069c116-0407-47d6-bbaa-512ed0fc13a2,ENDED,4.2,2019-07-02 12:37:33,2019-07-02 12:37:34,10.110.215.196,1587,10.2.163.107,80,TCP,64000,64000,43,43,ACCEPTED,86,128000
226,ef0d63cd-c976-4949-bf80-9df5fba96071,ENDED,4.2,2019-07-02 12:25:44,2019-07-02 12:25:44,10.110.215.196,1587,10.2.163.106,80,TCP,64000,64000,43,43,ACCEPTED,86,128000
227,d45bb1f0-c82b-4b0c-ac36-8aa25a03e280,ENDED,4.2,2019-07-02 12:25:58,2019-07-02 12:25:58,10.110.215.196,1587,10.2.163.106,80,TCP,64000,64000,43,43,ACCEPTED,86,128000
228,1fa1cc2e-1390-465b-8d4d-ba7e2a8266a5,ENDED,4.2,2019-07-02 12:27:22,2019-07-02 12:27:23,10.110.215.196,1587,10.2.163.106,80,TCP,8096000,8096000,5355,5355,ACCEPTED,10710,16192000
229,40d77b91-0dde-4ec0-9284-22ee7f154632,ENDED,4.2,2019-07-02 12:44:31,2019-07-02 12:44:32,35.178.22.102,1253,10.2.163.108,80,TCP,489,489,1,1,ACCEPTED,2,978
230,dac102ac-9c8f-4494-ab49-4d4185513cf4,ENDED,4.2,2019-07-02 12:19:24,2019-07-02 12:19:25,10.110.215.196,1587,10.2.163.105,80,TCP,64000,64000,43,43,ACCEPTED,86,128000
231,6747d88a-6422-432e-ab85-ab88dc882f3b,ENDED,4.2,2019-07-02 12:00:25,2019-07-02 12:00:25,10.110.215.196,1587,10.2.163.108,80,TCP,64000,64000,43,43,ACCEPTED,86,128000
232,0f41d1af-1d45-438e-917a-8511ebaafa83,ENDED,4.2,2019-07-02 12:34:41,2019-07-02 12:34:41,10.110.215.196,1587,10.2.163.108,80,TCP,64000,64000,43,43,ACCEPTED,86,128000
233,693bd584-99d9-420b-b162-f50c46090944,ENDED,4.2,2019-07-02 12:46:11,2019-07-02 12:46:11,10.110.215.196,1587,10.2.163.104,80,TCP,64000,64000,43,43,ACCEPTED,86,128000
234,9b5062ea-17b7-4f79-a65d-c0990316f8e8,ENDED,4.2,2019-07-02 12:52:53,2019-07-02 12:52:53,10.110.215.196,1587,10.2.163.104,80,TCP,64000,64000,43,43,ACCEPTED,86,128000
235,b308a8d5-ce00-4e32-873e-321fa9b87ae7,ENDED,4.2,2019-07-02 12:55:19,2019-07-02 12:55:19,10.110.215.196,1587,10.2.163.104,80,TCP,64000,64000,43,43,ACCEPTED,86,128000
236,26d95e9c-d60b-4549-b0da-e52fbd02177e,ENDED,4.2,2019-07-02 12:00:51,2019-07-02 12:00:51,10.110.215.196,1587,10.2.163.108,80,TCP,64000,64000,43,43,ACCEPTED,86,128000
237,2d2ff9e3-f328-4f45-80d0-6eec47fa8117,ENDED,4.2,2019-07-02 12:17:15,2019-07-02 12:17:16,54.210.206.49,2352,10.2.163.105,80,TCP,1312,1312,1,1,ACCEPTED,2,2624
238,c9d25264-1953-43b2-be73-b7585bc25442,ENDED,4.2,2019-07-02 12:23:09,2019-07-02 12:23:09,54.210.206.49,2352,10.2.163.105,80,TCP,1568,1568,2,2,ACCEPTED,4,3136
239,f8ae274b-8127-4d38-bc63-88932a14aa58,ENDED,4.2,2019-07-02 12:28:27,2019-07-02 12:28:27,10.110.215.196,1587,10.2.163.105,80,TCP,64000,64000,43,43,ACCEPTED,86,128000
240,4a258fb3-34d2-47d3-862a-cb2f3f50b0fc,ENDED,4.2,2019-07-02 12:35:52,2019-07-02 12:35:52,10.110.215.196,1587,10.2.163.108,80,TCP,64000,64000,43,43,ACCEPTED,86,128000
241,dd2f648b-8359-4163-bd28-759ee543ef3c,ENDED,4.2,2019-07-02 12:38:19,2019-07-02 12:38:19,10.110.215.196,1587,10.2.163.108,80,TCP,64000,64000,43,43,ACCEPTED,86,128000
242,bee711ce-c500-46dd-a9a4-68b125ebb26a,ENDED,4.2,2019-07-02 12:38:41,2019-07-02 12:38:41,10.110.215.196,1587,10.2.163.108,80,TCP,64000,64000,43,43,ACCEPTED,86,128000
243,a6a09cbb-4a9f-4dfa-ab35-27db13919367,ENDED,4.2,2019-07-02 12:52:52,2019-07-02 12:52:52,10.110.215.196,1587,10.2.163.106,80,TCP,64000,64000,43,43,ACCEPTED,86,128000
244,ef16a710-8519-4b22-925b-ab2e4f41c66e,ENDED,4.2,2019-07-02 12:08:51,2019-07-02 12:08:51,10.110.215.196,1587,10.2.163.107,80,TCP,64000,64000,43,43,ACCEPTED,86,128000
245,dc8bd027-31df-48f6-90c4-9e4f55408c6d,ENDED,4.2,2019-07-02 12:11:00,2019-07-02 12:11:01,10.110.215.196,1587,10.2.163.107,80,TCP,64000,64000,43,43,ACCEPTED,86,128000
246,c12ea546-687c-4b0b-ab63-fad1da55b88a,ENDED,4.2,2019-07-02 12:39:56,2019-07-02 12:39:57,54.210.144.91,2352,10.2.163.103,80,TCP,1712,1712,2,2,ACCEPTED,4,3424
247,0efba56b-ee4c-4e72-910a-415222e400d9,ENDED,4.2,2019-07-02 12:50:42,2019-07-02 12:50:43,54.210.144.91,2352,10.2.163.104,80,TCP,35984,35984,24,24,ACCEPTED,48,71968
248,fef81e4d-5a72-4d99-a1bc-a9131abd99fa,ENDED,4.2,2019-07-02 12:05:45,2019-07-02 12:05:49,54.210.206.49,2352,10.2.163.108,80,TCP,1344,1344,1,1,ACCEPTED,2,2688
249,f598ad79-eb19-4e03-9bda-9c043e228d75,ENDED,4.2,2019-07-02 12:16:45,2019-07-02 12:16:46,10.110.215.196,1587,10.2.163.105,80,TCP,64000,64000,43,43,ACCEPTED,86,128000
250,5d8bd6ef-ed62-4b24-adc1-503471caf430,ENDED,4.2,2019-07-02 12:17:19,2019-07-02 12:17:19,10.110.215.196,1587,10.2.163.103,80,TCP,64000,64000,43,43,ACCEPTED,86,128000
251,66687b83-db9c-44e7-a59d-5f8b4113adad,ENDED,4.2,2019-07-02 12:17:47,2019-07-02 12:17:47,10.110.215.196,1587,10.2.163.105,80,TCP,64000,64000,43,43,ACCEPTED,86,128000
252,014e10c6-1e6d-46d5-b8f3-cc3af1909112,ENDED,4.2,2019-07-02 12:18:51,2019-07-02 12:18:51,10.110.215.196,1587,10.2.163.103,80,TCP,64000,64000,43,43,ACCEPTED,86,128000
253,a8ac7aec-bd8e-4984-b5d2-4c1b3f504b34,ENDED,4.2,2019-07-02 12:19:36,2019-07-02 12:19:37,10.110.215.196,1587,10.2.163.103,80,TCP,64000,64000,43,43,ACCEPTED,86,128000
254,9729b40a-15ab-4e66-acc1-ec44dd7fd6cb,ENDED,4.2,2019-07-02 12:35:05,2019-07-02 12:35:06,10.110.215.196,1587,10.2.163.107,80,TCP,64000,64000,43,43,ACCEPTED,86,128000
255,35c7c5c3-338d-418f-8943-dc9e7ffc0b84,ENDED,4.2,2019-07-02 12:44:35,2019-07-02 12:44:36,10.110.215.196,1587,10.2.163.107,80,TCP,64000,64000,43,43,ACCEPTED,86,128000
256,274d4fd1-790a-48dc-a8f3-135f565245c6,ENDED,4.2,2019-07-02 12:49:14,2019-07-02 12:49:15,54.210.144.91,2352,10.2.163.104,80,TCP,5472,5472,4,4,ACCEPTED,8,10944
257,b4307435-0914-4e95-8d6e-a4a1818ce6ed,ENDED,4.2,2019-07-02 12:52:01,2019-07-02 12:52:01,54.210.144.91,2352,10.2.163.104,80,TCP,17856,17856,12,12,ACCEPTED,24,35712
258,66647a7e-9b35-4dec-bc64-7c974a0ce102,ENDED,4.2,2019-07-02 12:52:06,2019-07-02 12:52:06,54.210.144.91,2352,10.2.163.104,80,TCP,79072,79072,53,53,ACCEPTED,106,158144
259,9b61dbb2-ffca-4c60-9eb8-6d12cdcd528c,ENDED,4.2,2019-07-02 12:52:33,2019-07-02 12:52:33,54.210.144.91,2352,10.2.163.104,80,TCP,7696,7696,6,6,ACCEPTED,12,15392
260,041b9773-6dfd-404d-afd3-d64edc84f7a5,ENDED,4.2,2019-07-02 12:58:44,2019-07-02 12:58:44,54.210.206.49,2352,10.2.163.105,80,TCP,3344,3344,3,3,ACCEPTED,6,6688
261,d0222233-b46f-477c-ba69-fe69974d5118,ENDED,4.2,2019-07-02 12:00:06,2019-07-02 12:00:06,10.110.215.196,1587,10.2.163.106,80,TCP,64000,64000,43,43,ACCEPTED,86,128000
262,8bf5d89d-19c8-4461-a4bb-6c6a11161d97,ENDED,4.2,2019-07-02 12:00:09,2019-07-02 12:00:09,10.110.215.196,1587,10.2.163.108,80,TCP,64000,64000,43,43,ACCEPTED,86,128000
263,add7a2ec-2d0a-4626-b233-d48a1d2499e7,ENDED,4.2,2019-07-02 12:38:42,2019-07-02 12:38:43,10.110.215.196,1587,10.2.163.108,80,TCP,64000,64000,43,43,ACCEPTED,86,128000
264,66f16ccb-2366-47cb-a6bc-b249d0c2f0da,ENDED,4.2,2019-07-02 12:43:47,2019-07-02 12:43:47,10.110.215.196,1587,10.2.163.104,80,TCP,64000,64000,43,43,ACCEPTED,86,128000
265,448834af-1eb1-47dd-8f1a-373bbce70848,ENDED,4.2,2019-07-02 12:43:54,2019-07-02 12:43:55,10.110.215.196,1587,10.2.163.107,80,TCP,64000,64000,43,43,ACCEPTED,86,128000
266,b5604a7a-a35d-4b58-95fc-a76456bf02d1,ENDED,4.2,2019-07-02 12:45:30,2019-07-02 12:45:30,10.110.215.196,1587,10.2.163.107,80,TCP,64000,64000,43,43,ACCEPTED,86,128000
267,280aedbc-49d9-468a-ac1b-08c5f6ec736f,ENDED,4.2,2019-07-02 12:45:59,2019-07-02 12:45:59,10.110.215.196,1587,10.2.163.104,80,TCP,64000,64000,43,43,ACCEPTED,86,128000
268,7d6fa72e-74b2-4f39-8c89-190cfae09846,ENDED,4.2,2019-07-02 12:46:46,2019-07-02 12:46:46,10.110.215.196,1587,10.2.163.107,80,TCP,64000,64000,43,43,ACCEPTED,86,128000
269,4a14f0e9-e881-4d14-adaf-a9c7ff216e3f,ENDED,4.2,2019-07-02 12:47:30,2019-07-02 12:47:30,10.110.215.196,1587,10.2.163.107,80,TCP,64000,64000,43,43,ACCEPTED,86,128000
270,bbe2edaf-b2bf-43cb-bea4-6aca6c85293d,ENDED,4.2,2019-07-02 12:16:27,2019-07-02 12:16:27,10.2.163.95,2799,10.2.163.105,80,TCP,32,32,1,1,ACCEPTED,2,64
271,62061205-c7fc-4922-9542-60a3231fa191,ENDED,4.2,2019-07-02 12:33:38,2019-07-02 12:33:38,52.90.83.149,2352,10.2.163.106,80,TCP,18320,18320,13,13,ACCEPTED,26,36640
272,94dc8047-8753-49cc-8ff3-a30961dd69ec,ENDED,4.2,2019-07-02 12:10:19,2019-07-02 12:10:20,54.210.206.49,2352,10.2.163.108,80,TCP,24800,24800,17,17,ACCEPTED,34,49600
273,5926d425-7160-4069-be70-940ad988acc9,ENDED,4.2,2019-07-02 12:56:39,2019-07-02 12:56:39,54.210.206.49,2352,10.2.163.103,80,TCP,4976,4976,4,4,ACCEPTED,8,9952
274,f033296b-ab3a-4192-8011-4b57787599be,ENDED,4.2,2019-07-02 12:00:13,2019-07-02 12:00:13,10.110.215.196,1587,10.2.163.106,80,TCP,64000,64000,43,43,ACCEPTED,86,128000
275,9b1fdbf4-0105-414f-8a34-df3c4f9fcda7,ENDED,4.2,2019-07-02 12:07:05,2019-07-02 12:07:05,10.110.215.196,1587,10.2.163.104,80,TCP,64000,64000,43,43,ACCEPTED,86,128000
276,564db546-d1c8-4b09-aefa-247907dbdfcb,ENDED,4.2,2019-07-02 12:43:57,2019-07-02 12:43:57,10.110.215.196,1587,10.2.163.107,80,TCP,64000,64000,43,43,ACCEPTED,86,128000
277,4b5074b3-238e-42b1-a4b2-781b96fd3183,ENDED,4.2,2019-07-02 12:09:43,2019-07-02 12:09:44,10.110.215.196,1587,10.2.163.107,80,TCP,8096000,8096000,5355,5355,ACCEPTED,10710,16192000
278,04ee0b61-4624-47f6-bc40-0a1a25fb2a43,ENDED,4.2,2019-07-02 12:27:10,2019-07-02 12:27:10,10.110.215.196,1587,10.2.163.105,80,TCP,64000,64000,43,43,ACCEPTED,86,128000
279,1da54e12-1b7c-457f-ac71-2ec75525f793,ENDED,4.2,2019-07-02 12:28:11,2019-07-02 12:28:11,54.210.206.49,2352,10.2.163.104,80,TCP,3232,3232,3,3,ACCEPTED,6,6464
280,1f24db03-2295-4fed-a8b9-ed3383f12b06,ENDED,4.2,2019-07-02 12:28:46,2019-07-02 12:28:46,10.110.215.196,1587,10.2.163.105,80,TCP,64000,64000,43,43,ACCEPTED,86,128000
281,8f5e789e-f279-4ce5-958c-79758c643bed,ENDED,4.2,2019-07-02 12:30:03,2019-07-02 12:30:03,10.110.215.196,1587,10.2.163.105,80,TCP,64000,64000,43,43,ACCEPTED,86,128000
282,4ac057e0-55c2-4dcd-bf91-848f20f45cee,ENDED,4.2,2019-07-02 12:30:37,2019-07-02 12:30:38,54.210.206.49,2352,10.2.163.104,80,TCP,2768,2768,2,2,ACCEPTED,4,5536
283,0c1ad400-5cd7-43dc-ba85-c83b214d0cc1,ENDED,4.2,2019-07-02 12:54:28,2019-07-02 12:54:28,10.110.215.196,1587,10.2.163.104,80,TCP,64000,64000,43,43,ACCEPTED,86,128000
284,041893a2-8d7e-49c4-b154-f180519d7f1a,ENDED,4.2,2019-07-02 12:55:52,2019-07-02 12:55:52,10.110.215.196,1587,10.2.163.104,80,TCP,64000,64000,43,43,ACCEPTED,86,128000
285,ec5233b9-270e-44d9-a2af-bd058cd0d0e0,ENDED,4.2,2019-07-01 11:17:44,2019-07-01 11:17:44,45.33.26.0,1253,10.2.163.105,80,TCP,489,489,1,1,ACCEPTED,2,978
286,5e25650d-44dd-4722-90f6-3693ea3a85e5,ENDED,4.2,2019-07-01 11:49:23,2019-07-01 11:49:23,10.110.215.0,1587,10.2.163.103,80,TCP,64000,64000,43,43,ACCEPTED,86,128000
287,c11b453a-577d-494e-bdcb-232ad8262f18,ENDED,4.2,2019-07-01 11:58:35,2019-07-01 11:58:35,10.110.215.0,1587,10.2.163.107,80,TCP,64000,64000,43,43,ACCEPTED,86,128000
288,26c60019-2da1-41ac-a5e8-5f76fd06a35c,ENDED,4.2,2019-07-01 11:05:00,2019-07-01 11:05:00,10.110.215.0,1587,10.2.163.106,80,TCP,64000,64000,43,43,ACCEPTED,86,128000
289,af2d0309-62e3-46a7-a497-be533a7f2d62,ENDED,4.2,2019-07-01 11:06:15,2019-07-01 11:06:16,10.110.215.0,1587,10.2.163.104,80,TCP,64000,64000,43,43,ACCEPTED,86,128000
290,08aef79e-b14f-4903-a94c-99300cca7744,ENDED,4.2,2019-07-01 11:30:23,2019-07-01 11:30:23,10.110.215.0,1587,10.2.163.103,80,TCP,64000,64000,43,43,ACCEPTED,86,128000
291,36955925-23cb-4fd2-ad0b-3a0335181efd,ENDED,4.2,2019-07-01 11:33:30,2019-07-01 11:33:30,10.110.215.0,1587,10.2.163.103,80,TCP,64000,64000,43,43,ACCEPTED,86,128000
292,643034ea-239a-46aa-94ab-322da077f441,ENDED,4.2,2019-07-01 11:49:37,2019-07-01 11:49:38,10.133.44.0,1472,10.2.163.106,80,TCP,25,25,1,1,ACCEPTED,2,50
293,4efaec01-1324-491f-a013-9117a28beaa8,ENDED,4.2,2019-07-01 11:04:45,2019-07-01 11:04:46,10.110.215.0,1587,10.2.163.106,80,TCP,64000,64000,43,43,ACCEPTED,86,128000
294,8358c03b-9381-4d3a-b3dd-3e4c93f9d8c3,ENDED,4.2,2019-07-01 11:49:26,2019-07-01 11:49:26,10.110.215.0,1587,10.2.163.103,80,TCP,64000,64000,43,43,ACCEPTED,86,128000
295,8daa1a95-c918-4593-b2d3-c1d6829ab694,ENDED,4.2,2019-07-01 11:56:41,2019-07-01 11:56:41,10.110.215.0,1587,10.2.163.104,80,TCP,64000,64000,43,43,ACCEPTED,86,128000
296,bec30a2e-a0f2-40d3-bb76-b5c3e4912562,ENDED,4.2,2019-07-01 11:52:18,2019-07-01 11:52:18,10.110.215.0,1587,10.2.163.103,80,TCP,64000,64000,43,43,ACCEPTED,86,128000
297,f89b1a33-61ae-4935-82e7-f4aed9d453c7,ENDED,4.2,2019-07-01 11:07:25,2019-07-01 11:07:25,35.173.200.0,2352,10.2.163.106,80,TCP,48,48,1,1,ACCEPTED,2,96
298,e745b49e-77f5-4a9d-8e5b-11f1e7c79c5b,ENDED,4.2,2019-07-01 11:20:48,2019-07-01 11:20:48,10.110.215.0,1587,10.2.163.108,80,TCP,64000,64000,43,43,ACCEPTED,86,128000
299,83832125-0455-4e1b-9486-304c50c9eeae,ENDED,4.2,2019-07-01 11:23:08,2019-07-01 11:23:08,10.110.215.0,1587,10.2.163.108,80,TCP,64000,64000,43,43,ACCEPTED,86,128000
300,7adb8fdf-e735-44cd-8599-27ceccb3bd65,ENDED,4.2,2019-07-01 11:22:10,2019-07-01 11:22:11,10.110.215.0,1587,10.2.163.108,80,TCP,64000,64000,43,43,ACCEPTED,86,128000
301,449de49c-9264-45a4-aaa1-d1c21349b248,ENDED,4.2,2019-07-01 11:49:05,2019-07-01 11:49:05,10.110.215.0,1587,10.2.163.103,80,TCP,64000,64000,43,43,ACCEPTED,86,128000
302,c0cc5fea-5807-43eb-90db-8e8bbc410e72,ENDED,4.2,2019-07-01 11:07:21,2019-07-01 11:07:21,10.110.215.0,1587,10.2.163.104,80,TCP,64000,64000,43,43,ACCEPTED,86,128000
303,6e0ae94c-8b4a-4911-a5df-17acecdb9572,ENDED,4.2,2019-07-01 11:40:34,2019-07-01 11:40:35,10.110.215.0,1587,10.2.163.108,80,TCP,64000,64000,43,43,ACCEPTED,86,128000
304,480bb0cd-da75-4ec0-b60a-e32db571f0c0,ENDED,4.2,2019-07-01 11:41:31,2019-07-01 11:41:31,10.110.215.0,1587,10.2.163.108,80,TCP,64000,64000,43,43,ACCEPTED,86,128000
305,8001908d-5e02-4a3f-b8c6-1e19c17d0721,ENDED,4.2,2019-07-01 11:49:46,2019-07-01 11:49:47,52.87.236.0,2352,10.2.163.106,80,TCP,2176,2176,2,2,ACCEPTED,4,4352
306,2ca2679d-309f-4033-b78f-59d2a74a4640,ENDED,4.2,2019-07-01 11:33:22,2019-07-01 11:33:23,10.110.215.0,1587,10.2.163.103,80,TCP,8096000,8096000,5355,5355,ACCEPTED,10710,16192000
307,995e4ea4-1151-4f38-b1ff-1a5a7a05df0b,ENDED,4.2,2019-07-01 11:34:05,2019-07-01 11:34:05,10.110.215.0,1587,10.2.163.103,80,TCP,64000,64000,43,43,ACCEPTED,86,128000
308,0baacd42-c800-4c67-aa83-72a580d22d66,ENDED,4.2,2019-07-01 11:48:04,2019-07-01 11:48:04,10.110.215.0,1587,10.2.163.103,80,TCP,64000,64000,43,43,ACCEPTED,86,128000
309,5fe9308c-601a-40c3-9835-9f855b563f88,ENDED,4.2,2019-07-01 11:46:10,2019-07-01 11:46:11,10.2.163.0,2799,10.2.163.105,80,TCP,32,32,1,1,ACCEPTED,2,64
310,1befeb18-f505-499a-ab00-c34eb922f6e2,ENDED,4.2,2019-07-01 11:06:08,2019-07-01 11:06:08,10.110.215.0,1587,10.2.163.106,80,TCP,64000,64000,43,43,ACCEPTED,86,128000
311,28645536-35a2-48df-8b51-327d6778f84c,ENDED,4.2,2019-07-01 11:07:15,2019-07-01 11:07:29,10.110.214.0,2581,10.2.163.106,80,TCP,3425608,3425608,2266,2266,ACCEPTED,4532,6851216
312,184c4f7a-8247-4502-b222-0ca3a0a86a74,ENDED,4.2,2019-07-01 11:29:41,2019-07-01 11:29:41,10.110.215.0,1587,10.2.163.103,80,TCP,64000,64000,43,43,ACCEPTED,86,128000
313,288ece6f-d16a-4e63-9ba9-02e9ef509f4f,ENDED,4.2,2019-07-01 11:38:53,2019-07-01 11:38:54,10.110.215.0,1587,10.2.163.108,80,TCP,64000,64000,43,43,ACCEPTED,86,128000
314,b5d139d8-8a28-493f-b07b-ef725b8e1ce9,ENDED,4.2,2019-07-01 11:57:14,2019-07-01 11:57:15,10.110.215.0,1587,10.2.163.104,80,TCP,64000,64000,43,43,ACCEPTED,86,128000
315,82fa9f27-4904-4394-9765-5b86a2924320,ENDED,4.2,2019-07-01 11:59:48,2019-07-01 11:59:49,10.110.215.0,1587,10.2.163.104,80,TCP,64000,64000,43,43,ACCEPTED,86,128000
316,227e5d5b-de14-4756-b232-b07f804bd1b6,ENDED,4.2,2019-07-01 11:07:14,2019-07-01 11:07:14,10.110.215.0,1587,10.2.163.104,80,TCP,64000,64000,43,43,ACCEPTED,86,128000
317,42b52e31-0457-44ae-9822-42994ce0f1b3,ENDED,4.2,2019-07-01 11:39:49,2019-07-01 11:39:50,10.110.215.0,1587,10.2.163.104,80,TCP,8096000,8096000,5355,5355,ACCEPTED,10710,16192000
318,12086ed6-37f3-4c2b-9a65-57205623fb61,ENDED,4.2,2019-07-01 11:14:17,2019-07-01 11:14:18,52.23.209.0,2352,10.2.163.108,80,TCP,534880,534880,354,354,ACCEPTED,708,1069760
319,c772e506-15d5-4024-90e4-698ab2b9fbfe,ENDED,4.2,2019-07-01 11:28:40,2019-07-01 11:28:42,168.1.64.0,1602,10.2.163.106,80,TCP,12000000,12000000,7937,7937,ACCEPTED,15874,24000000
320,118da746-ec4b-4437-8b3a-4e730699fa6c,ENDED,4.2,2019-07-01 11:32:45,2019-07-01 11:32:45,10.110.215.0,1587,10.2.163.107,80,TCP,64000,64000,43,43,ACCEPTED,86,128000
321,130accc2-476d-4a35-852d-6fcb3c02158f,ENDED,4.2,2019-07-01 11:22:17,2019-07-01 11:22:17,10.110.215.0,1587,10.2.163.107,80,TCP,64000,64000,43,43,ACCEPTED,86,128000
322,587808f2-fac9-49aa-bf25-8347411ac482,ENDED,4.2,2019-07-01 11:22:39,2019-07-01 11:22:40,10.110.215.0,1587,10.2.163.107,80,TCP,8096000,8096000,5355,5355,ACCEPTED,10710,16192000
323,3acb500b-1309-4149-807b-0889632e7461,ENDED,4.2,2019-07-01 11:24:32,2019-07-01 11:24:33,10.110.215.0,1587,10.2.163.107,80,TCP,8096000,8096000,5355,5355,ACCEPTED,10710,16192000
324,83ca98b3-3317-49ed-9e69-b0202f1c3eed,ENDED,4.2,2019-07-01 11:42:32,2019-07-01 11:42:32,10.110.215.0,1587,10.2.163.108,80,TCP,64000,64000,43,43,ACCEPTED,86,128000
325,74b488bf-fed7-4367-8050-066ed2b15a96,ENDED,4.2,2019-07-01 11:58:01,2019-07-01 11:58:01,52.87.236.0,2352,10.2.163.105,80,TCP,3536,3536,3,3,ACCEPTED,6,7072
326,1180ae23-a421-4be2-8904-8f7e4782ead4,ENDED,4.2,2019-07-01 11:58:31,2019-07-01 11:58:32,10.110.215.0,1587,10.2.163.104,80,TCP,64000,64000,43,43,ACCEPTED,86,128000
327,afd39fdf-d10c-48a6-b6bd-430b77ade1f5,ENDED,4.2,2019-07-01 11:42:30,2019-07-01 11:42:31,3.84.59.0,2352,10.2.163.105,80,TCP,147936,147936,98,98,ACCEPTED,196,295872
328,e7625338-694e-41b2-9375-72131d4bf96a,ENDED,4.2,2019-07-01 11:24:23,2019-07-01 11:24:23,10.110.215.0,1587,10.2.163.107,80,TCP,64000,64000,43,43,ACCEPTED,86,128000
329,98a6fa8e-041c-4fc6-9345-6817022d3afd,ENDED,4.2,2019-07-01 11:41:57,2019-07-01 11:41:58,3.84.59.0,2352,10.2.163.108,80,TCP,1536,1536,2,2,ACCEPTED,4,3072
330,0428b606-d360-450a-a71d-a6f8a713a3f8,ENDED,4.2,2019-07-01 11:14:32,2019-07-01 11:14:32,10.110.215.0,1587,10.2.163.104,80,TCP,64000,64000,43,43,ACCEPTED,86,128000
331,d7355ede-67ca-4b8a-8003-a816d4fc1d45,ENDED,4.2,2019-07-01 11:25:10,2019-07-01 11:25:10,10.110.215.0,1587,10.2.163.107,80,TCP,64000,64000,43,43,ACCEPTED,86,128000
332,a1e987e2-a549-49d9-99e0-8dcd3a445a2d,ENDED,4.2,2019-07-01 11:29:45,2019-07-01 11:29:46,10.110.215.0,1587,10.2.163.107,80,TCP,64000,64000,43,43,ACCEPTED,86,128000
333,8d9c0d97-f2ab-4f90-8b3e-0186e4fc1e96,ENDED,4.2,2019-07-01 11:30:41,2019-07-01 11:30:42,10.110.215.0,1587,10.2.163.107,80,TCP,64000,64000,43,43,ACCEPTED,86,128000
334,2410b604-aba4-4345-91da-57131b8b429f,ENDED,4.2,2019-07-01 11:30:46,2019-07-01 11:30:47,10.110.215.0,1587,10.2.163.107,80,TCP,64000,64000,43,43,ACCEPTED,86,128000
335,d197911c-e26b-4e67-be76-4a08dbceec3b,ENDED,4.2,2019-07-01 11:30:51,2019-07-01 11:30:51,10.110.215.0,1587,10.2.163.107,80,TCP,64000,64000,43,43,ACCEPTED,86,128000
336,102e7275-b6b8-40af-a074-c5faa489593c,ENDED,4.2,2019-07-01 11:31:31,2019-07-01 11:31:31,10.110.215.0,1587,10.2.163.107,80,TCP,64000,64000,43,43,ACCEPTED,86,128000
337,3d1accbd-de46-48fb-8994-adfdef5679a2,ENDED,4.2,2019-07-01 11:39:48,2019-07-01 11:39:48,10.110.215.0,1587,10.2.163.108,80,TCP,64000,64000,43,43,ACCEPTED,86,128000
338,d8e44e12-4751-4625-b76f-e19c960781fb,ENDED,4.2,2019-07-01 11:57:47,2019-07-01 11:57:47,10.110.215.0,1587,10.2.163.104,80,TCP,64000,64000,43,43,ACCEPTED,86,128000
339,b4d93d37-41db-4431-8c62-e1aea56bda3b,ENDED,4.2,2019-07-01 11:01:08,2019-07-01 11:01:08,35.173.200.0,2352,10.2.163.103,80,TCP,29728,29728,20,20,ACCEPTED,40,59456
340,f1055994-162e-415e-9b96-1d821aa361b2,ENDED,4.2,2019-07-01 11:09:52,2019-07-01 11:09:52,13.55.72.0,1253,10.2.163.105,80,TCP,489,489,1,1,ACCEPTED,2,978
341,0f500b0b-cdf7-45bb-abc9-af225d2928eb,ENDED,4.2,2019-07-01 11:14:50,2019-07-01 11:14:51,10.110.215.0,1587,10.2.163.104,80,TCP,64000,64000,43,43,ACCEPTED,86,128000
342,3c0f5e8e-270c-41e3-8839-17366ec1a254,ENDED,4.2,2019-07-01 11:32:13,2019-07-01 11:32:13,10.110.215.0,1587,10.2.163.107,80,TCP,64000,64000,43,43,ACCEPTED,86,128000
343,d3305176-166a-4b2e-af79-1a6916d6bcd9,ENDED,4.2,2019-07-01 11:54:45,2019-07-01 11:54:46,52.87.236.0,2352,10.2.163.108,80,TCP,2016,2016,2,2,ACCEPTED,4,4032
344,dabc3abe-da72-417a-a545-ff0e59feb2a4,ENDED,4.2,2019-07-01 11:01:11,2019-07-01 11:01:12,52.23.209.0,2352,10.2.163.108,80,TCP,83744,83744,56,56,ACCEPTED,112,167488
345,085f3316-0b04-440e-93a6-ca14e868e781,ENDED,4.2,2019-07-01 11:02:37,2019-07-01 11:02:37,52.23.209.0,2352,10.2.163.108,80,TCP,9696,9696,7,7,ACCEPTED,14,19392
346,0e2b54d3-e70d-4b23-894e-65c8e7aed5b1,ENDED,4.2,2019-07-01 11:14:29,2019-07-01 11:14:29,10.110.215.0,1587,10.2.163.104,80,TCP,64000,64000,43,43,ACCEPTED,86,128000
347,4a90aa1f-28c9-4ad2-88ce-442bb54a9de0,ENDED,4.2,2019-07-01 11:29:57,2019-07-01 11:29:57,10.110.215.0,1587,10.2.163.107,80,TCP,64000,64000,43,43,ACCEPTED,86,128000
348,8da38b9c-4f1c-404f-91b3-8ac50db2d060,ENDED,4.2,2019-07-01 11:38:33,2019-07-01 11:38:33,10.110.215.0,1587,10.2.163.104,80,TCP,64000,64000,43,43,ACCEPTED,86,128000
349,65690e32-29ff-4b76-9e06-02c68a86bafd,ENDED,4.2,2019-07-01 11:39:56,2019-07-01 11:39:56,10.110.215.0,1587,10.2.163.108,80,TCP,64000,64000,43,43,ACCEPTED,86,128000
350,7175fc87-14a6-4c03-a9d3-e986b950b098,ENDED,4.2,2019-07-01 11:41:09,2019-07-01 11:41:09,10.110.215.0,1587,10.2.163.104,80,TCP,64000,64000,43,43,ACCEPTED,86,128000
351,93d8a674-9682-4404-9b74-70def357b96b,ENDED,4.2,2019-07-01 11:10:36,2019-07-01 11:10:37,3.94.101.0,2352,10.2.163.106,80,TCP,2080,2080,2,2,ACCEPTED,4,4160
352,7bc70062-715f-4c20-a161-631706eea4e5,ENDED,4.2,2019-07-01 11:11:52,2019-07-01 11:11:53,10.110.215.0,1587,10.2.163.105,80,TCP,64000,64000,43,43,ACCEPTED,86,128000
353,5aa8b947-9b3e-4889-9242-f3a9ca09983c,ENDED,4.2,2019-07-01 11:12:54,2019-07-01 11:12:54,10.110.215.0,1587,10.2.163.105,80,TCP,64000,64000,43,43,ACCEPTED,86,128000
354,2826c393-22c6-4055-98d7-d4608205e1bf,ENDED,4.2,2019-07-01 11:13:34,2019-07-01 11:13:35,10.110.215.0,1587,10.2.163.105,80,TCP,64000,64000,43,43,ACCEPTED,86,128000
355,9133a64a-2c80-47a7-8922-f603f91796e8,ENDED,4.2,2019-07-01 11:13:48,2019-07-01 11:13:48,10.110.215.0,1587,10.2.163.105,80,TCP,64000,64000,43,43,ACCEPTED,86,128000
356,a8f000a6-d345-4513-8a85-3242aa4f30bf,ENDED,4.2,2019-07-01 11:14:03,2019-07-01 11:14:03,10.110.215.0,1587,10.2.163.105,80,TCP,64000,64000,43,43,ACCEPTED,86,128000
357,1aad1a01-397e-433e-be29-78cbaded4e87,ENDED,4.2,2019-07-01 11:58:01,2019-07-01 11:58:02,52.87.236.0,2352,10.2.163.108,80,TCP,294720,294720,195,195,ACCEPTED,390,589440
358,f45ee47e-db82-4c1a-907d-838de8f282b4,ENDED,4.2,2019-07-01 11:14:06,2019-07-01 11:14:07,10.110.215.0,1587,10.2.163.105,80,TCP,8096000,8096000,5355,5355,ACCEPTED,10710,16192000
359,07080801-6684-417c-be1b-aba25e2c8134,ENDED,4.2,2019-07-01 11:21:51,2019-07-01 11:21:53,3.94.101.0,2352,10.2.163.105,80,TCP,3248,3248,3,3,ACCEPTED,6,6496
360,ed4d2e15-736e-471c-af70-f30265bba9c4,ENDED,4.2,2019-07-01 11:12:02,2019-07-01 11:12:02,10.110.215.0,1587,10.2.163.104,80,TCP,64000,64000,43,43,ACCEPTED,86,128000
361,334a7f1f-5f0b-4d29-b4be-2fedb8bf03d0,ENDED,4.2,2019-07-01 11:24:22,2019-07-01 11:24:23,10.110.215.0,1587,10.2.163.107,80,TCP,64000,64000,43,43,ACCEPTED,86,128000
362,967d6138-d9d7-4974-83d2-2903e04af4e8,ENDED,4.2,2019-07-01 11:39:29,2019-07-01 11:39:30,169.56.149.0,1602,10.2.163.107,80,TCP,12000000,12000000,7937,7937,ACCEPTED,15874,24000000
363,6fda699a-7558-4fd5-a253-bb440be8a19a,ENDED,4.2,2019-07-02 18:05:09,2019-07-02 18:05:09,10.110.215.196,1587,10.2.163.106,80,TCP,64000,64000,43,43,ACCEPTED,86,128000
364,40fd028d-562c-4065-b38a-c98cef6646e7,ENDED,4.2,2019-07-02 18:32:49,2019-07-02 18:32:50,10.162.208.118,1602,10.2.163.105,80,TCP,12000000,12000000,7937,7937,ACCEPTED,15874,24000000
365,c4b8debf-0210-4cdb-9865-28d010c92cee,ENDED,4.2,2019-07-02 18:11:19,2019-07-02 18:11:19,10.110.215.196,1587,10.2.163.105,80,TCP,64000,64000,43,43,ACCEPTED,86,128000
366,59e5fd90-b2c0-4e68-857c-3b63c684214c,ENDED,4.2,2019-07-02 18:13:17,2019-07-02 18:13:18,10.110.215.196,1587,10.2.163.105,80,TCP,64000,64000,43,43,ACCEPTED,86,128000
367,84f02bee-d72c-4a65-a217-37c5597a1085,ENDED,4.2,2019-07-02 18:42:46,2019-07-02 18:42:46,13.55.72.115,1253,10.2.163.106,80,TCP,489,489,1,1,ACCEPTED,2,978
368,74d19438-d0c5-4cd6-9542-61a23c692a7b,ENDED,4.2,2019-07-02 18:16:46,2019-07-02 18:16:47,54.210.206.49,2352,10.2.163.106,80,TCP,17264,17264,12,12,ACCEPTED,24,34528
369,258b8834-f978-4c1e-8228-1847aee01c22,ENDED,4.2,2019-07-02 18:11:46,2019-07-02 18:11:47,54.210.206.49,2352,10.2.163.106,80,TCP,16848,16848,12,12,ACCEPTED,24,33696
370,9d162db4-2cf4-40b2-8273-9e8177241001,ENDED,4.2,2019-07-02 18:27:42,2019-07-02 18:27:44,10.139.17.194,1602,10.2.163.106,80,TCP,12000000,12000000,7937,7937,ACCEPTED,15874,24000000
371,901078ef-f791-45ed-aeaa-c614fb28e8f2,ENDED,4.2,2019-07-02 18:47:23,2019-07-02 18:47:24,52.90.83.149,2352,10.2.163.108,80,TCP,865984,865984,573,573,ACCEPTED,1146,1731968
372,f83c18c5-117a-4e51-93ff-fe5e12f4ff8c,ENDED,4.2,2019-07-02 18:18:28,2019-07-02 18:18:29,54.152.216.199,2352,10.2.163.106,80,TCP,2032,2032,2,2,ACCEPTED,4,4064
373,77e1f80c-8e22-40fa-9f4c-cb9b25ada8ee,ENDED,4.2,2019-07-02 18:00:33,2019-07-02 18:00:33,54.173.221.36,2352,10.2.163.103,80,TCP,1632,1632,2,2,ACCEPTED,4,3264
374,497370e2-06ee-469f-944a-713bfc3059d6,ENDED,4.2,2019-07-02 18:55:23,2019-07-02 18:55:23,54.210.206.49,2352,10.2.163.103,80,TCP,2624,2624,2,2,ACCEPTED,4,5248
375,8207a5ea-fad5-4693-99b3-e5fc40fd7a83,ENDED,4.2,2019-07-02 18:21:31,2019-07-02 18:21:31,10.110.215.196,1587,10.2.163.105,80,TCP,64000,64000,43,43,ACCEPTED,86,128000
376,30b109ff-e52e-4885-a7ce-08da7a9eddf9,ENDED,4.2,2019-07-02 18:30:29,2019-07-02 18:30:29,10.110.215.196,1587,10.2.163.105,80,TCP,64000,64000,43,43,ACCEPTED,86,128000
377,78a7a3ef-bbe6-47a6-8bf1-5f6bd5ec456c,ENDED,4.2,2019-07-02 18:47:33,2019-07-02 18:47:34,10.110.215.196,1587,10.2.163.107,80,TCP,64000,64000,43,43,ACCEPTED,86,128000
378,9ed9834d-1838-4f02-a144-4b1bc7885bee,ENDED,4.2,2019-07-02 18:47:57,2019-07-02 18:47:57,10.110.215.196,1587,10.2.163.107,80,TCP,64000,64000,43,43,ACCEPTED,86,128000
379,b99daa7a-9467-4de5-b154-f1deeb022977,ENDED,4.2,2019-07-02 18:49:59,2019-07-02 18:50:00,10.110.215.196,1587,10.2.163.103,80,TCP,64000,64000,43,43,ACCEPTED,86,128000
380,4f8ff27d-6e5b-4b6d-a7d5-826ce0f71f3a,ENDED,4.2,2019-07-02 18:51:10,2019-07-02 18:51:10,54.173.221.36,2352,10.2.163.103,80,TCP,1312,1312,1,1,ACCEPTED,2,2624
381,406af5a7-921f-452e-b0cd-de5adc2efc96,ENDED,4.2,2019-07-02 18:52:20,2019-07-02 18:52:21,10.110.215.196,1587,10.2.163.107,80,TCP,64000,64000,43,43,ACCEPTED,86,128000
382,7fcf4490-cc00-4096-a775-5105af9b2555,ENDED,4.2,2019-07-02 18:23:51,2019-07-02 18:23:52,10.110.215.196,1587,10.2.163.105,80,TCP,64000,64000,43,43,ACCEPTED,86,128000
383,9687888f-5dd0-4e2a-804b-f9ca4b8baa7b,ENDED,4.2,2019-07-02 18:30:54,2019-07-02 18:30:55,10.110.215.196,1587,10.2.163.104,80,TCP,64000,64000,43,43,ACCEPTED,86,128000
384,cdacf1eb-f1f9-4151-90bb-7820f0dfd89b,ENDED,4.2,2019-07-02 18:57:32,2019-07-02 18:57:33,54.173.221.36,2352,10.2.163.105,80,TCP,3504,3504,3,3,ACCEPTED,6,7008
385,d7c9809b-efef-42f1-a0e1-5a2c042d5bac,ENDED,4.2,2019-07-02 18:02:41,2019-07-02 18:02:42,10.110.215.196,1587,10.2.163.107,80,TCP,64000,64000,43,43,ACCEPTED,86,128000
386,480db09b-76e3-4301-ba87-2619f3c8a293,ENDED,4.2,2019-07-02 18:20:20,2019-07-02 18:20:21,10.110.215.196,1587,10.2.163.105,80,TCP,64000,64000,43,43,ACCEPTED,86,128000
387,5350dfa9-2a9b-49ab-8ee8-01c6cf5c20a7,ENDED,4.2,2019-07-02 18:24:11,2019-07-02 18:24:11,10.110.215.196,1587,10.2.163.105,80,TCP,64000,64000,43,43,ACCEPTED,86,128000
388,d6d5cc30-e222-47c9-8b26-a0787a980b83,ENDED,4.2,2019-07-02 18:27:21,2019-07-02 18:27:22,54.210.144.91,2352,10.2.163.103,80,TCP,1696,1696,2,2,ACCEPTED,4,3392
389,ad0ce499-2f6b-49b7-b008-9b55fa9ee410,ENDED,4.2,2019-07-02 18:30:36,2019-07-02 18:30:36,10.110.215.196,1587,10.2.163.105,80,TCP,64000,64000,43,43,ACCEPTED,86,128000
390,41e10815-c828-47e7-afed-dfe1771907b2,ENDED,4.2,2019-07-02 18:32:58,2019-07-02 18:32:59,10.110.215.196,1587,10.2.163.105,80,TCP,64000,64000,43,43,ACCEPTED,86,128000
391,7408499a-d956-47d2-b951-ab520db2e130,ENDED,4.2,2019-07-02 18:33:04,2019-07-02 18:33:05,10.110.215.196,1587,10.2.163.105,80,TCP,64000,64000,43,43,ACCEPTED,86,128000
392,2aaaa5cc-5e23-42e1-88c8-64d78b130d0f,ENDED,4.2,2019-07-02 18:33:35,2019-07-02 18:33:35,10.110.215.196,1587,10.2.163.105,80,TCP,64000,64000,43,43,ACCEPTED,86,128000
393,b4224939-8fce-4125-968d-a979103a26c8,ENDED,4.2,2019-07-02 18:39:08,2019-07-02 18:39:08,10.110.215.196,1587,10.2.163.104,80,TCP,64000,64000,43,43,ACCEPTED,86,128000
394,96ae3e53-3bb7-4a6c-b8fb-64053f6899f1,ENDED,4.2,2019-07-02 18:39:28,2019-07-02 18:39:28,10.110.215.196,1587,10.2.163.104,80,TCP,64000,64000,43,43,ACCEPTED,86,128000
395,88aaa0c6-9457-4c8c-984a-a13a042cb0d1,ENDED,4.2,2019-07-02 18:50:53,2019-07-02 18:50:53,10.110.215.196,1587,10.2.163.103,80,TCP,64000,64000,43,43,ACCEPTED,86,128000
396,ed79362f-8e1c-4d43-98af-6a37ac2b267a,ENDED,4.2,2019-07-02 18:11:28,2019-07-02 18:11:28,10.110.215.196,1587,10.2.163.108,80,TCP,64000,64000,43,43,ACCEPTED,86,128000
397,6beb59b3-fb66-4142-b989-19161d95e1e0,ENDED,4.2,2019-07-02 18:15:56,2019-07-02 18:15:56,10.110.215.196,1587,10.2.163.108,80,TCP,64000,64000,43,43,ACCEPTED,86,128000
398,6984cc71-c3e7-4b97-9403-1db1eaa619cd,ENDED,4.2,2019-07-02 18:31:46,2019-07-02 18:31:46,10.110.215.196,1587,10.2.163.104,80,TCP,64000,64000,43,43,ACCEPTED,86,128000
399,31df888e-8d36-46f5-bf61-758bf4f9e6a9,ENDED,4.2,2019-07-02 18:32:24,2019-07-02 18:32:24,10.110.215.196,1587,10.2.163.104,80,TCP,64000,64000,43,43,ACCEPTED,86,128000
400,3402d0ae-eea2-4218-a0b8-4640bd6ccc40,ENDED,4.2,2019-07-02 18:48:57,2019-07-02 18:48:58,52.90.83.149,2352,10.2.163.103,80,TCP,80944,80944,54,54,ACCEPTED,108,161888
401,0a4ef989-079a-4646-9b18-4c591d8eb168,ENDED,4.2,2019-07-02 18:02:47,2019-07-02 18:02:47,10.110.215.196,1587,10.2.163.106,80,TCP,64000,64000,43,43,ACCEPTED,86,128000
402,b033893f-826b-4f5e-9b43-21ef8ff7d901,ENDED,4.2,2019-07-02 18:14:27,2019-07-02 18:14:27,10.110.215.196,1587,10.2.163.108,80,TCP,64000,64000,43,43,ACCEPTED,86,128000
403,503a76ce-3148-4b9c-b885-a99d8c2f5a4d,ENDED,4.2,2019-07-02 18:22:54,2019-07-02 18:22:56,54.210.206.49,2352,10.2.163.108,80,TCP,1536,1536,2,2,ACCEPTED,4,3072
404,b85f7e77-d3da-4f4a-8dee-cda54cd84b9b,ENDED,4.2,2019-07-02 18:48:15,2019-07-02 18:48:15,10.110.215.196,1587,10.2.163.107,80,TCP,64000,64000,43,43,ACCEPTED,86,128000
405,5c69dd3f-2bbb-40ea-853a-de55a4c5df24,ENDED,4.2,2019-07-02 18:49:25,2019-07-02 18:49:25,10.110.215.196,1587,10.2.163.107,80,TCP,64000,64000,43,43,ACCEPTED,86,128000
406,726abda7-0cab-4ed6-8b32-9290c5ea7858,ENDED,4.2,2019-07-02 18:10:24,2019-07-02 18:10:25,54.173.221.36,2352,10.2.163.105,80,TCP,3536,3536,3,3,ACCEPTED,6,7072
407,b93ed89c-73ae-46ab-b92f-5c85cf51dbd8,ENDED,4.2,2019-07-02 18:24:31,2019-07-02 18:24:31,10.110.215.196,1587,10.2.163.105,80,TCP,64000,64000,43,43,ACCEPTED,86,128000
408,c6d017fa-c8d7-4634-ac62-ed7a32a51fd9,ENDED,4.2,2019-07-02 18:39:08,2019-07-02 18:39:08,10.110.215.196,1587,10.2.163.104,80,TCP,64000,64000,43,43,ACCEPTED,86,128000
409,935fb2dc-cf45-4a42-a257-d5cbb6c6b74a,ENDED,4.2,2019-07-02 18:47:31,2019-07-02 18:47:32,10.110.215.196,1587,10.2.163.103,80,TCP,64000,64000,43,43,ACCEPTED,86,128000
410,3da8b677-82fe-4630-b275-289254b2264b,ENDED,4.2,2019-07-02 18:48:27,2019-07-02 18:48:27,10.110.215.196,1587,10.2.163.103,80,TCP,64000,64000,43,43,ACCEPTED,86,128000
411,88e80423-887c-4444-b96b-3fe6d55fbdaa,ENDED,4.2,2019-07-02 18:50:00,2019-07-02 18:50:02,10.116.130.72,1602,10.2.163.105,80,TCP,12000000,12000000,7937,7937,ACCEPTED,15874,24000000
412,37c39489-91f5-42d2-9593-3fe7098faf2f,ENDED,4.2,2019-07-02 18:52:08,2019-07-02 18:52:08,10.110.215.196,1587,10.2.163.103,80,TCP,64000,64000,43,43,ACCEPTED,86,128000
413,aa6bc1a6-58aa-4427-9f84-5d1e42db0cb3,ENDED,4.2,2019-07-02 18:03:29,2019-07-02 18:03:29,10.110.215.196,1587,10.2.163.107,80,TCP,64000,64000,43,43,ACCEPTED,86,128000
414,a1bb8bfb-cb6d-4b5f-8508-ed881844949b,ENDED,4.2,2019-07-02 18:20:56,2019-07-02 18:20:57,54.173.221.36,2352,10.2.163.107,80,TCP,1328,1328,1,1,ACCEPTED,2,2656
415,cd44661a-e3af-426e-8853-04bcd5b34683,ENDED,4.2,2019-07-02 18:22:26,2019-07-02 18:22:27,54.173.221.36,2352,10.2.163.107,80,TCP,1328,1328,1,1,ACCEPTED,2,2656
416,d13034b3-e88a-455e-9110-b976491d8c75,ENDED,4.2,2019-07-02 18:23:49,2019-07-02 18:23:50,54.173.221.36,2352,10.2.163.107,80,TCP,1328,1328,1,1,ACCEPTED,2,2656
417,f07f0f86-c918-418d-827f-a798688b2b33,ENDED,4.2,2019-07-02 18:38:55,2019-07-02 18:38:56,10.110.215.196,1587,10.2.163.104,80,TCP,64000,64000,43,43,ACCEPTED,86,128000
418,226916a4-20d3-4284-92f4-f4ed16a37f55,ENDED,4.2,2019-07-02 18:39:29,2019-07-02 18:39:29,10.110.215.196,1587,10.2.163.104,80,TCP,64000,64000,43,43,ACCEPTED,86,128000
419,3539cd20-f8c4-4731-9072-135960771d94,ENDED,4.2,2019-07-02 18:03:51,2019-07-02 18:03:51,10.110.215.196,1587,10.2.163.107,80,TCP,64000,64000,43,43,ACCEPTED,86,128000
420,f1e9708d-3904-4bc0-8ee7-21d70207c331,ENDED,4.2,2019-07-02 18:23:58,2019-07-02 18:23:59,10.174.98.69,1602,10.2.163.107,80,TCP,12000000,12000000,7937,7937,ACCEPTED,15874,24000000
421,995b5ae6-15bb-4b08-a261-0b14f9e902a4,ENDED,4.2,2019-07-02 18:40:03,2019-07-02 18:40:04,10.110.215.196,1587,10.2.163.104,80,TCP,64000,64000,43,43,ACCEPTED,86,128000
422,eca15667-98df-4aef-9a02-e83c78036659,ENDED,4.2,2019-07-02 18:41:16,2019-07-02 18:41:16,10.110.215.196,1587,10.2.163.104,80,TCP,64000,64000,43,43,ACCEPTED,86,128000
423,4a7d4e70-626e-4337-8faa-b685a7db7027,ENDED,4.2,2019-07-02 18:56:49,2019-07-02 18:56:49,10.110.215.196,1587,10.2.163.104,80,TCP,64000,64000,43,43,ACCEPTED,86,128000
424,9037272a-3757-4f03-89c3-97abbfeb2148,ENDED,4.2,2019-07-02 18:57:35,2019-07-02 18:57:35,10.110.215.196,1587,10.2.163.108,80,TCP,64000,64000,43,43,ACCEPTED,86,128000
425,bcd471af-ad44-436d-9e51-9a15b3a90258,ENDED,4.2,2019-07-02 18:59:13,2019-07-02 18:59:13,10.110.215.196,1587,10.2.163.108,80,TCP,64000,64000,43,43,ACCEPTED,86,128000
426,2bf234ba-9114-43f6-8ff7-161d48eb9b1c,ENDED,4.2,2019-07-02 18:04:09,2019-07-02 18:04:10,10.110.215.196,1587,10.2.163.106,80,TCP,64000,64000,43,43,ACCEPTED,86,128000
427,f339defb-4043-4be7-bc92-b6d9539be72e,ENDED,4.2,2019-07-02 18:24:24,2019-07-02 18:24:24,10.110.215.196,1587,10.2.163.103,80,TCP,64000,64000,43,43,ACCEPTED,86,128000
428,d8fd3af8-f7c0-4808-bff0-465f1d426300,ENDED,4.2,2019-07-02 18:14:44,2019-07-02 18:14:45,10.110.215.196,1587,10.2.163.108,80,TCP,64000,64000,43,43,ACCEPTED,86,128000
429,10269f10-4db6-47b3-9397-9db6714059f2,ENDED,4.2,2019-07-02 18:15:13,2019-07-02 18:15:13,10.110.215.196,1587,10.2.163.108,80,TCP,64000,64000,43,43,ACCEPTED,86,128000
430,d3d03f35-95bc-4662-90f9-9f44596aeb13,ENDED,4.2,2019-07-02 18:21:01,2019-07-02 18:21:01,10.110.215.196,1587,10.2.163.103,80,TCP,64000,64000,43,43,ACCEPTED,86,128000
431,e50eea73-6f25-45bf-ad8c-57b97668fc8c,ENDED,4.2,2019-07-02 18:32:14,2019-07-02 18:32:15,10.174.98.69,1602,10.2.163.104,80,TCP,12000000,12000000,7937,7937,ACCEPTED,15874,24000000
432,596ea781-9422-4517-ad9c-98c1118a50b9,ENDED,4.2,2019-07-02 18:20:50,2019-07-02 18:20:51,54.210.206.49,2352,10.2.163.104,80,TCP,5968,5968,4,4,ACCEPTED,8,11936
433,8f65a0ac-21a6-44da-b9ab-17a1073250ca,ENDED,4.2,2019-07-02 18:25:26,2019-07-02 18:25:27,54.173.221.36,2352,10.2.163.103,80,TCP,10400,10400,7,7,ACCEPTED,14,20800
434,bfae4d06-c307-4b95-b859-3c400575ee15,ENDED,4.2,2019-07-02 18:58:25,2019-07-02 18:58:25,10.110.215.196,1587,10.2.163.104,80,TCP,64000,64000,43,43,ACCEPTED,86,128000
435,531624b7-ab2a-4d62-bbc3-960880c55e7e,ENDED,4.2,2019-07-01 18:39:40,2019-07-01 18:39:42,3.83.1.0,2352,10.2.163.104,80,TCP,385968,385968,256,256,ACCEPTED,512,771936
436,ac5c71eb-743c-4ea5-a592-3beb6904607d,ENDED,4.2,2019-07-01 18:19:28,2019-07-01 18:19:28,10.110.215.0,1587,10.2.163.103,80,TCP,64000,64000,43,43,ACCEPTED,86,128000
437,920aa1bf-90e8-4229-a821-57f7ba97fe70,ENDED,4.2,2019-07-01 18:20:54,2019-07-01 18:20:55,34.203.244.0,2352,10.2.163.103,80,TCP,5280,5280,4,4,ACCEPTED,8,10560
438,9096e78f-67a3-49f4-9b55-9c6685deb168,ENDED,4.2,2019-07-01 18:55:27,2019-07-01 18:55:27,3.88.28.0,2352,10.2.163.108,80,TCP,1824,1824,2,2,ACCEPTED,4,3648
439,91db6dd8-7ad3-4418-92ca-f702f3a8f95d,ENDED,4.2,2019-07-01 18:56:37,2019-07-01 18:56:37,3.88.28.0,2352,10.2.163.108,80,TCP,5072,5072,4,4,ACCEPTED,8,10144
440,138b7ecf-14f0-45cc-94d3-b89033129e50,ENDED,4.2,2019-07-01 18:56:49,2019-07-01 18:56:49,3.88.28.0,2352,10.2.163.108,80,TCP,455888,455888,302,302,ACCEPTED,604,911776
441,9af40bd5-ecce-43ab-9f50-cfee432b65d0,ENDED,4.2,2019-07-01 18:10:07,2019-07-01 18:10:07,10.110.215.0,1587,10.2.163.105,80,TCP,64000,64000,43,43,ACCEPTED,86,128000
442,35902105-f059-469d-a2a7-b20baf3ff429,ENDED,4.2,2019-07-01 18:19:24,2019-07-01 18:19:24,10.110.215.0,1587,10.2.163.104,80,TCP,64000,64000,43,43,ACCEPTED,86,128000
443,4be4e6a7-b3ce-4774-a86b-cc6379f4585c,ENDED,4.2,2019-07-01 18:00:21,2019-07-01 18:00:21,10.110.215.0,1587,10.2.163.104,80,TCP,64000,64000,43,43,ACCEPTED,86,128000
444,984279ee-504b-4044-be7c-4453c7a7c1ef,ENDED,4.2,2019-07-01 18:09:18,2019-07-01 18:09:18,10.110.215.0,1587,10.2.163.103,80,TCP,64000,64000,43,43,ACCEPTED,86,128000
445,00bc0c89-efee-4981-bfc3-030adb9cda79,ENDED,4.2,2019-07-01 18:06:57,2019-07-01 18:06:58,18.195.163.0,1253,10.2.163.108,80,TCP,489,489,1,1,ACCEPTED,2,978
446,3ab74ff1-7f33-4b35-a7c6-ed82fc97f833,ENDED,4.2,2019-07-01 18:20:13,2019-07-01 18:20:14,10.110.215.0,1587,10.2.163.104,80,TCP,64000,64000,43,43,ACCEPTED,86,128000
447,41d83eff-3302-4543-8aa1-ff914af3e9ec,ENDED,4.2,2019-07-01 18:37:37,2019-07-01 18:37:38,10.110.215.0,1587,10.2.163.104,80,TCP,8096000,8096000,5355,5355,ACCEPTED,10710,16192000
448,c82eac5e-842d-445c-9a85-9542c1625752,ENDED,4.2,2019-07-01 18:00:51,2019-07-01 18:00:51,10.110.215.0,1587,10.2.163.104,80,TCP,64000,64000,43,43,ACCEPTED,86,128000
449,5ec9f4aa-dcad-405e-b612-afc83aabc06c,ENDED,4.2,2019-07-01 18:12:02,2019-07-01 18:12:03,10.110.215.0,1587,10.2.163.103,80,TCP,64000,64000,43,43,ACCEPTED,86,128000
450,a3702458-4226-477c-80eb-7f8ce167d056,ENDED,4.2,2019-07-01 18:45:38,2019-07-01 18:45:39,3.94.82.0,2352,10.2.163.103,80,TCP,5088,5088,4,4,ACCEPTED,8,10176
451,a48e533c-025c-43dd-a830-6cab720cec21,ENDED,4.2,2019-07-01 18:56:07,2019-07-01 18:56:08,3.88.28.0,2352,10.2.163.105,80,TCP,272672,272672,181,181,ACCEPTED,362,545344
452,195c5bab-8a09-4d73-9be8-a73d18b89380,ENDED,4.2,2019-07-01 18:08:15,2019-07-01 18:08:16,10.110.215.0,1587,10.2.163.105,80,TCP,8096000,8096000,5355,5355,ACCEPTED,10710,16192000
453,e199045c-fc1c-4e36-934e-e71738654130,ENDED,4.2,2019-07-01 18:17:13,2019-07-01 18:17:13,10.110.215.0,1587,10.2.163.104,80,TCP,64000,64000,43,43,ACCEPTED,86,128000
454,513f5624-2bcc-4c92-afd9-8e51a5b67588,ENDED,4.2,2019-07-01 18:19:10,2019-07-01 18:19:10,10.110.215.0,1587,10.2.163.104,80,TCP,64000,64000,43,43,ACCEPTED,86,128000
455,d9e6c722-b672-4538-975f-540846bffc76,ENDED,4.2,2019-07-01 18:00:14,2019-07-01 18:00:14,10.110.215.0,1587,10.2.163.104,80,TCP,64000,64000,43,43,ACCEPTED,86,128000
456,8947d664-8c1e-4c65-a437-f1057f1d68c3,ENDED,4.2,2019-07-01 18:38:20,2019-07-01 18:38:21,3.94.82.0,2352,10.2.163.103,80,TCP,10576,10576,7,7,ACCEPTED,14,21152
457,d4880a96-64ac-4de7-977b-e44b195944cd,ENDED,4.2,2019-07-01 18:41:04,2019-07-01 18:41:04,3.94.82.0,2352,10.2.163.103,80,TCP,407264,407264,270,270,ACCEPTED,540,814528
458,ce098c25-2488-4a73-80dc-ef1a7928762e,ENDED,4.2,2019-07-01 18:56:12,2019-07-01 18:56:12,3.88.28.0,2352,10.2.163.105,80,TCP,7264,7264,5,5,ACCEPTED,10,14528
459,dd8d2d23-6e75-42fb-9d8c-8d6c4379de19,ENDED,4.2,2019-07-01 18:59:31,2019-07-01 18:59:31,3.94.82.0,2352,10.2.163.103,80,TCP,2048,2048,2,2,ACCEPTED,4,4096
460,1a2845e0-a9d1-43da-926e-51056da2c057,ENDED,4.2,2019-07-01 18:32:42,2019-07-01 18:32:42,3.94.82.0,2352,10.2.163.105,80,TCP,237344,237344,157,157,ACCEPTED,314,474688
461,dec39f6b-5afa-4e93-8394-1f2674260861,ENDED,4.2,2019-07-01 18:24:42,2019-07-01 18:24:42,13.114.248.0,1253,10.2.163.104,80,TCP,489,489,1,1,ACCEPTED,2,978
462,9dd24052-5a23-4022-8f8c-39a3a277a028,ENDED,4.2,2019-07-01 18:40:43,2019-07-01 18:40:44,3.94.82.0,2352,10.2.163.105,80,TCP,3216,3216,3,3,ACCEPTED,6,6432
463,4d5520d8-9da3-45e5-9a9d-fe803d844bcf,ENDED,4.2,2019-07-01 18:47:12,2019-07-01 18:47:13,10.110.215.0,1587,10.2.163.106,80,TCP,8096000,8096000,5355,5355,ACCEPTED,10710,16192000
464,daf0834d-9f27-47bf-af6a-41997562e007,ENDED,4.2,2019-07-01 18:01:58,2019-07-01 18:01:58,10.110.215.0,1587,10.2.163.103,80,TCP,64000,64000,43,43,ACCEPTED,86,128000
465,314996e3-1a23-4202-86c2-5b87be59f587,ENDED,4.2,2019-07-01 18:02:00,2019-07-01 18:02:03,34.203.244.0,2352,10.2.163.106,80,TCP,36848,36848,25,25,ACCEPTED,50,73696
466,ac6af700-ee24-4dfd-8e34-8425fc9aa912,ENDED,4.2,2019-07-01 18:08:50,2019-07-01 18:08:50,34.203.244.0,2352,10.2.163.106,80,TCP,174832,174832,116,116,ACCEPTED,232,349664
467,713671a2-e4ff-4d77-bc20-5eddd68589e0,ENDED,4.2,2019-07-01 18:03:04,2019-07-01 18:03:04,10.110.215.0,1587,10.2.163.103,80,TCP,8096000,8096000,5355,5355,ACCEPTED,10710,16192000
468,64390c2c-e6ae-4a5c-813c-e6a177eb11e5,ENDED,4.2,2019-07-01 18:14:30,2019-07-01 18:14:30,34.203.244.0,2352,10.2.163.106,80,TCP,10128,10128,7,7,ACCEPTED,14,20256
469,e0e10517-4dcb-46f0-b971-81b80a1d876e,ENDED,4.2,2019-07-01 18:41:27,2019-07-01 18:41:28,3.83.1.0,2352,10.2.163.104,80,TCP,614528,614528,407,407,ACCEPTED,814,1229056
470,453ba024-3481-4829-8533-48945a90f509,ENDED,4.2,2019-07-01 18:45:59,2019-07-01 18:45:59,10.110.215.0,1587,10.2.163.107,80,TCP,64000,64000,43,43,ACCEPTED,86,128000
471,e0ff9a3f-2921-46f0-940e-877d14ff4ed3,ENDED,4.2,2019-07-01 18:47:30,2019-07-01 18:47:30,10.110.215.0,1587,10.2.163.107,80,TCP,64000,64000,43,43,ACCEPTED,86,128000
472,25d71b1e-d2b1-4cbe-92cf-601ab14ef1ae,ENDED,4.2,2019-07-01 18:33:18,2019-07-01 18:33:19,18.233.8.0,2352,10.2.163.104,80,TCP,142560,142560,95,95,ACCEPTED,190,285120
473,7c31a919-2003-4962-9fa1-59f639739105,ENDED,4.2,2019-07-01 18:44:54,2019-07-01 18:44:54,10.110.215.0,1587,10.2.163.107,80,TCP,64000,64000,43,43,ACCEPTED,86,128000
474,a1589ff2-579b-49b0-a030-957379c719a2,ENDED,4.2,2019-07-01 18:01:22,2019-07-01 18:01:23,10.110.215.0,1587,10.2.163.103,80,TCP,64000,64000,43,43,ACCEPTED,86,128000
475,2eaee39c-a913-4f69-bbaa-fcd51a7d8300,ENDED,4.2,2019-07-01 18:44:39,2019-07-01 18:44:39,10.110.215.0,1587,10.2.163.106,80,TCP,64000,64000,43,43,ACCEPTED,86,128000
476,cae7601c-98e3-490f-a7e4-c4d9de9c9b07,ENDED,4.2,2019-07-01 18:44:43,2019-07-01 18:44:43,10.110.215.0,1587,10.2.163.106,80,TCP,64000,64000,43,43,ACCEPTED,86,128000
477,3d810ef6-20a0-48b5-820f-b3aec55d9204,ENDED,4.2,2019-07-01 18:46:41,2019-07-01 18:46:41,10.110.215.0,1587,10.2.163.106,80,TCP,64000,64000,43,43,ACCEPTED,86,128000
478,1facb1c3-3fe4-4677-b9ec-2d62c1f8f93b,ENDED,4.2,2019-07-01 18:51:28,2019-07-01 18:51:29,10.143.99.0,1253,10.2.163.105,80,TCP,489,489,1,1,ACCEPTED,2,978
479,bd3f42af-89f3-4efe-b3ac-be478d636438,ENDED,4.2,2019-07-01 18:55:36,2019-07-01 18:55:36,10.110.215.0,1587,10.2.163.105,80,TCP,64000,64000,43,43,ACCEPTED,86,128000
480,726001a6-19a1-497f-a21a-aeab74eff410,ENDED,4.2,2019-07-01 18:56:45,2019-07-01 18:56:45,10.110.215.0,1587,10.2.163.105,80,TCP,64000,64000,43,43,ACCEPTED,86,128000
481,1001f015-a3de-482e-ad1a-bce482ad0f36,ENDED,4.2,2019-07-01 18:58:14,2019-07-01 18:58:15,10.110.215.0,1587,10.2.163.105,80,TCP,64000,64000,43,43,ACCEPTED,86,128000
482,4d65902f-f41a-4199-9cbe-179678010548,ENDED,4.2,2019-07-01 18:28:44,2019-07-01 18:28:44,10.110.215.0,1587,10.2.163.107,80,TCP,64000,64000,43,43,ACCEPTED,86,128000
483,87ca69bc-bf60-4b40-9a59-511d8a92d075,ENDED,4.2,2019-07-01 18:35:50,2019-07-01 18:35:51,10.110.215.0,1587,10.2.163.106,80,TCP,64000,64000,43,43,ACCEPTED,86,128000
484,c7d5a449-db5a-450f-806e-9c597e60473d,ENDED,4.2,2019-07-01 18:50:09,2019-07-01 18:50:09,3.88.28.0,2352,10.2.163.106,80,TCP,4320,4320,3,3,ACCEPTED,6,8640
485,53a61e9c-0cf7-4e13-93f3-07582a6488c1,ENDED,4.2,2019-07-01 18:29:39,2019-07-01 18:29:39,10.110.215.0,1587,10.2.163.107,80,TCP,64000,64000,43,43,ACCEPTED,86,128000
486,bbba427e-c3e6-4094-8e82-eb802b2cba92,ENDED,4.2,2019-07-01 18:34:01,2019-07-01 18:34:01,52.68.223.0,1253,10.2.163.103,80,TCP,489,489,1,1,ACCEPTED,2,978
487,37ff98bc-32d9-4c54-926a-8d8de1760a0d,ENDED,4.2,2019-07-01 18:36:19,2019-07-01 18:36:19,10.110.215.0,1587,10.2.163.106,80,TCP,64000,64000,43,43,ACCEPTED,86,128000
488,3b795893-c6ef-45b9-a2d5-0f0c81c384e6,ENDED,4.2,2019-07-01 18:58:35,2019-07-01 18:58:36,18.233.8.0,2352,10.2.163.108,80,TCP,4480,4480,3,3,ACCEPTED,6,8960
489,5c748359-f94b-418f-9e05-349c45ea5f15,ENDED,4.2,2019-07-01 18:33:33,2019-07-01 18:33:34,10.174.98.0,1602,10.2.163.108,80,TCP,12000000,12000000,7937,7937,ACCEPTED,15874,24000000
490,9a6647ff-2f43-4b08-9a7c-4e1beb88c8bd,ENDED,4.2,2019-07-01 18:26:53,2019-07-01 18:26:53,10.110.215.0,1587,10.2.163.107,80,TCP,64000,64000,43,43,ACCEPTED,86,128000
491,9bbb036c-387f-4757-a529-ca2504e5cb0f,ENDED,4.2,2019-07-01 18:00:06,2019-07-01 18:00:07,18.233.8.0,2352,10.2.163.103,80,TCP,1840,1840,2,2,ACCEPTED,4,3680
492,373e9f7e-e020-4f51-a539-5dbc6dea3cf7,ENDED,4.2,2019-07-01 18:29:05,2019-07-01 18:29:06,10.110.215.0,1587,10.2.163.107,80,TCP,8096000,8096000,5355,5355,ACCEPTED,10710,16192000
493,f1ac5bd3-fd97-4c2b-b6a2-4a02e3a5c732,ENDED,4.2,2019-07-01 18:30:21,2019-07-01 18:30:21,10.110.215.0,1587,10.2.163.107,80,TCP,64000,64000,43,43,ACCEPTED,86,128000
494,fd5c09e2-9f2d-4cdf-9542-3ad41392529d,ENDED,4.2,2019-07-01 18:53:58,2019-07-01 18:53:58,10.110.215.0,1587,10.2.163.103,80,TCP,64000,64000,43,43,ACCEPTED,86,128000
495,1e761db4-d4dc-4b75-bc36-5dd22aebd998,ENDED,4.2,2019-07-01 18:55:15,2019-07-01 18:55:15,10.110.215.0,1587,10.2.163.103,80,TCP,64000,64000,43,43,ACCEPTED,86,128000
496,d0b5a3e0-facd-4231-975c-dc5d8a38c1eb,ENDED,4.2,2019-07-01 18:57:09,2019-07-01 18:57:10,10.110.215.0,1587,10.2.163.103,80,TCP,64000,64000,43,43,ACCEPTED,86,128000
497,6a10f8f5-02d3-4dd2-afca-6d0c117c997b,ENDED,4.2,2019-07-01 18:58:03,2019-07-01 18:58:04,10.110.215.0,1587,10.2.163.103,80,TCP,64000,64000,43,43,ACCEPTED,86,128000
498,535c64e1-733f-4eef-a07c-9c131d871ec1,ENDED,4.2,2019-07-01 12:18:37,2019-07-01 12:18:37,10.110.215.0,1587,10.2.163.107,80,TCP,64000,64000,43,43,ACCEPTED,86,128000
499,a971fc55-7ec3-432f-abfe-8453f1db29ff,ENDED,4.2,2019-07-01 12:43:57,2019-07-01 12:43:58,10.110.215.0,1587,10.2.163.104,80,TCP,64000,64000,43,43,ACCEPTED,86,128000
